AAAAACTGTCCGGGCTACT: AAAACTGTCCGGGCTACTT
AAAAAGACATAGGATTCCA: AAAAGACATAGGATTCCAT
AAAAAGCACCGTTTTTGGG: AAAAGCACCGTTTTTGGGA
AAAACTGCCATAAAGCGAT: AAACTGCCATAAAGCGATT
AAAACTGTCCGGGCTACTT: AAACTGTCCGGGCTACTTG
AAAAGACATAGGATTCCAT: AAAGACATAGGATTCCATA
AAAAGATCGGGTGTTTGCA: AAAGATCGGGTGTTTGCAC
AAAAGCACCGTTTTTGGGA: AAAGCACCGTTTTTGGGAT
AAAAGCCACGCGTAAGCAA: AAAGCCACGCGTAAGCAAC
AAAAGCCATTGGGTACATT: AAAGCCATTGGGTACATTA
AAACAACTCGCGTATAAAT: AACAACTCGCGTATAAATC
AAACAGGACGAACCGGTCG: AACAGGACGAACCGGTCGC
AAACCCCACCGATTCCTCA: AACCCCACCGATTCCTCAG
AAACGCATAACTCGACAAG: AACGCATAACTCGACAAGT
AAACGGTAGTGTGCCCATC: AACGGTAGTGTGCCCATCG
AAACTATAAGGGCCACAAA: AACTATAAGGGCCACAAAT
AAACTCTTCATTGGTGCTA: AACTCTTCATTGGTGCTAT
AAACTGCCATAAAGCGATT: AACTGCCATAAAGCGATTC
AAACTGTCCGGGCTACTTG: AACTGTCCGGGCTACTTGC
AAAGACATAGGATTCCATA: AAGACATAGGATTCCATAA
AAAGATCGGGTGTTTGCAC: AAGATCGGGTGTTTGCACT
AAAGCACCGTTTTTGGGAT: AAGCACCGTTTTTGGGATC
AAAGCCACGCGTAAGCAAC: AAGCCACGCGTAAGCAACG
AAAGCCATGCACGGGACGT: AAGCCATGCACGGGACGTG
AAAGCCATTGGGTACATTA: AAGCCATTGGGTACATTAG
AAAGCGATTCGGCGACCCG: AAGCGATTCGGCGACCCGT
AAAGCGGAGCGTTGGTTGA: AAGCGGAGCGTTGGTTGAG
AAAGGGCAAGCTGGAAACT: AAGGGCAAGCTGGAAACTA
AAATACCAAAAACTGTCCG: AATACCAAAAACTGTCCGG
AAATAGACGAGACCTAAGC: AATAGACGAGACCTAAGCC
AAATCATTCTTTTGAAGGA: AATCATTCTTTTGAAGGAT
AAATCCTCCACTCTCTGAT: AATCCTCCACTCTCTGATC
AAATCGATGCTCTGGGGCC: AATCGATGCTCTGGGGCCA
AAATTACCAGTGCTAGCGA: AATTACCAGTGCTAGCGAT
AAATTTGGAAGCGCAGGGG: AATTTGGAAGCGCAGGGGA
AACAACTCGCGTATAAATC: ACAACTCGCGTATAAATCC
AACACAGGCTTTCCGACCT: ACACAGGCTTTCCGACCTA
AACACGTCGTTCTTCCTGC: ACACGTCGTTCTTCCTGCA
AACAGGACGAACCGGTCGC: ACAGGACGAACCGGTCGCC
AACATCTAACCCCGCGCCT: ACATCTAACCCCGCGCCTG
AACATGTACTACTCCCCAC: ACATGTACTACTCCCCACA
AACATTCGACGTATCCCCA: ACATTCGACGTATCCCCAA
AACATTCTCATCTATTGTA: ACATTCTCATCTATTGTAG
AACATTTCTGGGAGAAGTG: ACATTTCTGGGAGAAGTGG
AACCAAACCCCACCGATTC: ACCAAACCCCACCGATTCC
AACCAGGAGCAGCTGATTT: ACCAGGAGCAGCTGATTTG
AACCCCACCGATTCCTCAG: ACCCCACCGATTCCTCAGG
AACCCCGCGCCTGGTTTGA: ACCCCGCGCCTGGTTTGAT
AACCCGACGAACCGGTCGC: ACCCGACGAACCGGTCGCC
AACCGGTCGCCTACCAAAC: ACCGGTCGCCTACCAAACA
AACCGGTCGCCTACCCCCA: ACCGGTCGCCTACCCCCAC
AACCGGTCGCCTACCCGCC: ACCGGTCGCCTACCCGCCC
AACCGTTAACGCTCATCCC: ACCGTTAACGCTCATCCCG
AACGATCCGAGCGAACTTG: ACGATCCGAGCGAACTTGC
AACGCAATTTTTTTGTATT: ACGCAATTTTTTTGTATTA
AACGCATAACTCGACAAGT: ACGCATAACTCGACAAGTC
AACGCTCATCCCGACCACC: ACGCTCATCCCGACCACCA
AACGGGCGATCTCCCCTCC: ACGGGCGATCTCCCCTCCG
AACGGTAGTGTGCCCATCG: ACGGTAGTGTGCCCATCGT
AACTAAAGCCATGCACGGG: ACTAAAGCCATGCACGGGA
AACTACAGGTAGGAACACG: ACTACAGGTAGGAACACGT
AACTATAAGGGCCACAAAT: ACTATAAGGGCCACAAATA
AACTCGACAAGTCCCTGCC: ACTCGACAAGTCCCTGCCA
AACTCGCGTATAAATCCTC: ACTCGCGTATAAATCCTCC
AACTCGTATGTGTTGTGCA: ACTCGTATGTGTTGTGCAG
AACTCTTCATTGGTGCTAT: ACTCTTCATTGGTGCTATC
AACTGCACCTACGCCGGCT: ACTGCACCTACGCCGGCTC
AACTGCCATAAAGCGATTC: ACTGCCATAAAGCGATTCG
AACTGGGTCGGGCTGAGTC: ACTGGGTCGGGCTGAGTCC
AACTGTCCGGGCTACTTGC: ACTGTCCGGGCTACTTGCG
AACTTGCGAACCAGGAGCA: ACTTGCGAACCAGGAGCAG
AAGAATCAATACAAGGTGT: AGAATCAATACAAGGTGTA
AAGACATAATATCGTCTCG: AGACATAATATCGTCTCGA
AAGACATAGGATTCCATAA: AGACATAGGATTCCATAAA
AAGAGAGAATACTATAGGG: AGAGAGAATACTATAGGGT
AAGAGCCATTGTCTTGGCC: AGAGCCATTGTCTTGGCCA
AAGATCCAGAGTACTGTTT: AGATCCAGAGTACTGTTTC
AAGATCGGGTGTTTGCACT: AGATCGGGTGTTTGCACTT
AAGATGGCAGCCGGACAGG: AGATGGCAGCCGGACAGGA
AAGCAACGCAATTTTTTTG: AGCAACGCAATTTTTTTGT
AAGCACAGTACACGTGTTC: AGCACAGTACACGTGTTCT
AAGCACCGTTTTTGGGATC: AGCACCGTTTTTGGGATCA
AAGCCACGCGTAAGCAACG: AGCCACGCGTAAGCAACGC
AAGCCATGCACGGGACGTG: AGCCATGCACGGGACGTGC
AAGCCATGCGCGCGAATAC: AGCCATGCGCGCGAATACA
AAGCCATTGGGTACATTAG: AGCCATTGGGTACATTAGG
AAGCCTACGATAGCGTTCG: AGCCTACGATAGCGTTCGG
AAGCGATTCGGCGACCCGT: AGCGATTCGGCGACCCGTG
AAGCGCAGGGGATGTTCGT: AGCGCAGGGGATGTTCGTA
AAGCGGAGCGTTGGTTGAG: AGCGGAGCGTTGGTTGAGT
AAGCTCACCAACTAAAGCC: AGCTCACCAACTAAAGCCA
AAGCTGGAAACTATAAGGG: AGCTGGAAACTATAAGGGC
AAGGACTACGAGTGCCAGC: AGGACTACGAGTGCCAGCC
AAGGATGCCGGGATAGGGA: AGGATGCCGGGATAGGGAG
AAGGATTTTGAACCCGACG: AGGATTTTGAACCCGACGA
AAGGCGGCCTCGGTTGACG: AGGCGGCCTCGGTTGACGA
AAGGGAGATAAACAGGACG: AGGGAGATAAACAGGACGA
AAGGGCAAGCTGGAAACTA: AGGGCAAGCTGGAAACTAT
AAGGGCCACAAATAGACGA: AGGGCCACAAATAGACGAG
AAGGTACACGACTGCGAAG: AGGTACACGACTGCGAAGC
AAGGTCAGATCAGCGTATT: AGGTCAGATCAGCGTATTG
AAGGTGTAGCGGAAGCTCA: AGGTGTAGCGGAAGCTCAC
AAGGTTATAGCTCTGGACG: AGGTTATAGCTCTGGACGA
AAGTATGGAGGATACCTAT: AGTATGGAGGATACCTATT
AAGTCCCTGCCAAAAAGCA: AGTCCCTGCCAAAAAGCAC
AAGTCTCTTACTGCACTGT: AGTCTCTTACTGCACTGTT
AAGTGGATCTGGCGAATAT: AGTGGATCTGGCGAATATG
AATAAAAGCCATTGGGTAC: ATAAAAGCCATTGGGTACA
AATAAGAATCAATACAAGG: ATAAGAATCAATACAAGGT
AATAAGAGCCATTGTCTTG: ATAAGAGCCATTGTCTTGG
AATACAAGGTGTAGCGGAA: ATACAAGGTGTAGCGGAAG
AATACAGGTACCGTTCCAA: ATACAGGTACCGTTCCAAT
AATACCAAAAACTGTCCGG: ATACCAAAAACTGTCCGGG
AATACCACGCTTATAGATC: ATACCACGCTTATAGATCA
AATACTATAGGGTGTCACT: ATACTATAGGGTGTCACTT
AATAGACGAGACCTAAGCC: ATAGACGAGACCTAAGCCA
AATAGTGAGTGTAAGTATG: ATAGTGAGTGTAAGTATGG
AATATCGTCTCGAACTGCA: ATATCGTCTCGAACTGCAC
AATATGAGAAATCGATGCT: ATATGAGAAATCGATGCTC
AATCAATACAAGGTGTAGC: ATCAATACAAGGTGTAGCG
AATCATTCTTTTGAAGGAT: ATCATTCTTTTGAAGGATG
AATCCTCCACTCTCTGATC: ATCCTCCACTCTCTGATCA
AATCCTTTGTAGCCGCTCA: ATCCTTTGTAGCCGCTCAG
AATCGATGCTCTGGGGCCA: ATCGATGCTCTGGGGCCAC
AATCTATACACCAAAAGCC: ATCTATACACCAAAAGCCA
AATGAATAAGAATCAATAC: ATGAATAAGAATCAATACA
AATGGAGATCCTGGCCCCC: ATGGAGATCCTGGCCCCCT
AATGGGAAGTCTCTTACTG: ATGGGAAGTCTCTTACTGC
AATGGTGCGTTCTACCTGT: ATGGTGCGTTCTACCTGTC
AATGTACAGGGCCTGACCA: ATGTACAGGGCCTGACCAT
AATGTGGCTAAAAGATCGG: ATGTGGCTAAAAGATCGGG
AATTACAATAAGAGCCATT: ATTACAATAAGAGCCATTG
AATTACCAGTGCTAGCGAT: ATTACCAGTGCTAGCGATC
AATTGATTGCAACTGGGTC: ATTGATTGCAACTGGGTCG
AATTGTTTATGTTGCGCCG: ATTGTTTATGTTGCGCCGC
AATTTGGAAGCGCAGGGGA: ATTTGGAAGCGCAGGGGAT
AATTTTTTTGTATTATTGC: ATTTTTTTGTATTATTGCG
ACAAATAGACGAGACCTAA: CAAATAGACGAGACCTAAG
ACAACTCGCGTATAAATCC: CAACTCGCGTATAAATCCT
ACAACTCGTATGTGTTGTG: CAACTCGTATGTGTTGTGC
ACAAGGTGTAGCGGAAGCT: CAAGGTGTAGCGGAAGCTC
ACAAGTCCCTGCCAAAAAG: CAAGTCCCTGCCAAAAAGC
ACAATAAGAGCCATTGTCT: CAATAAGAGCCATTGTCTT
ACAATTGTTTATGTTGCGC: CAATTGTTTATGTTGCGCC
ACACAGGCTTTCCGACCTA: CACAGGCTTTCCGACCTAG
ACACCAAAAGCCACGCGTA: CACCAAAAGCCACGCGTAA
ACACCAGACCCATAGGTGG: CACCAGACCCATAGGTGGA
ACACGACTGCGAAGCCTAC: CACGACTGCGAAGCCTACG
ACACGGCACATCTTATTAC: CACGGCACATCTTATTACT
ACACGTCGTTCTTCCTGCA: CACGTCGTTCTTCCTGCAG
ACACGTGTTCTTCAACATC: CACGTGTTCTTCAACATCT
ACACTCATTGCAGACCAAA: CACTCATTGCAGACCAAAT
ACAGGACGAACCGGTCGCC: CAGGACGAACCGGTCGCCT
ACAGGATCGCAGCATAATG: CAGGATCGCAGCATAATGG
ACAGGCTTTCCGACCTAGT: CAGGCTTTCCGACCTAGTT
ACAGGGCCTGACCATGGGG: CAGGGCCTGACCATGGGGA
ACAGGTACCGTTCCAATGA: CAGGTACCGTTCCAATGAA
ACAGGTAGGAACACGTCGT: CAGGTAGGAACACGTCGTT
ACAGTACACGTGTTCTTCA: CAGTACACGTGTTCTTCAA
ACATAATATCGTCTCGAAC: CATAATATCGTCTCGAACT
ACATAGGATTCCATAAACT: CATAGGATTCCATAAACTC
ACATAGTTGAGTCGGGTCT: CATAGTTGAGTCGGGTCTG
ACATCTAACCCCGCGCCTG: CATCTAACCCCGCGCCTGG
ACATCTCGGCACGTAGCAA: CATCTCGGCACGTAGCAAC
ACATCTTATTACTAGCCCA: CATCTTATTACTAGCCCAC
ACATGTACTACTCCCCACA: CATGTACTACTCCCCACAA
ACATTAGGCTGTAAGATCC: CATTAGGCTGTAAGATCCA
ACATTCGACGTATCCCCAA: CATTCGACGTATCCCCAAA
ACATTCTCATCTATTGTAG: CATTCTCATCTATTGTAGC
ACATTTCTGGGAGAAGTGG: CATTTCTGGGAGAAGTGGA
ACCAAAAACTGTCCGGGCT: CCAAAAACTGTCCGGGCTA
ACCAAAAGCCACGCGTAAG: CCAAAAGCCACGCGTAAGC
ACCAAACAACTCGCGTATA: CCAAACAACTCGCGTATAA
ACCAAACCCCACCGATTCC: CCAAACCCCACCGATTCCT
ACCAAATACCAAAAACTGT: CCAAATACCAAAAACTGTC
ACCAACTAAAGCCATGCAC: CCAACTAAAGCCATGCACG
ACCAAGGATTTTGAACCCG: CCAAGGATTTTGAACCCGA
ACCAAGGCGGCCTCGGTTG: CCAAGGCGGCCTCGGTTGA
ACCAAGGGAGATAAACAGG: CCAAGGGAGATAAACAGGA
ACCAAGGTTATAGCTCTGG: CCAAGGTTATAGCTCTGGA
ACCACCAAGGATTTTGAAC: CCACCAAGGATTTTGAACC
ACCACCAAGGCGGCCTCGG: CCACCAAGGCGGCCTCGGT
ACCACCAAGGGAGATAAAC: CCACCAAGGGAGATAAACA
ACCACCAAGGTTATAGCTC: CCACCAAGGTTATAGCTCT
ACCACCGACGCGCTATTGC: CCACCGACGCGCTATTGCA
ACCACGCTTATAGATCAAG: CCACGCTTATAGATCAAGC
ACCAGACCCATAGGTGGAA: CCAGACCCATAGGTGGAAC
ACCAGGAGCAGCTGATTTG: CCAGGAGCAGCTGATTTGA
ACCAGTGCTAGCGATCTCG: CCAGTGCTAGCGATCTCGA
ACCATGGGGAGGGGAACCG: CCATGGGGAGGGGAACCGT
ACCCAGACCTAAAGCGGAG: CCCAGACCTAAAGCGGAGC
ACCCATAGGTGGAACGGGC: CCCATAGGTGGAACGGGCG
ACCCCACCGATTCCTCAGG: CCCCACCGATTCCTCAGGG
ACCCCCACGGGATCCGCTT: CCCCCACGGGATCCGCTTC
ACCCCGCGCCTGGTTTGAT: CCCCGCGCCTGGTTTGATG
ACCCGACGAACCGGTCGCC: CCCGACGAACCGGTCGCCT
ACCCGCCCGCTAAGAGAGA: CCCGCCCGCTAAGAGAGAA
ACCCGTGCTCGGGATTAGT: CCCGTGCTCGGGATTAGTC
ACCGAATTACAATAAGAGC: CCGAATTACAATAAGAGCC
ACCGACGCGCTATTGCATC: CCGACGCGCTATTGCATCG
ACCGATTCCTCAGGGAAGG: CCGATTCCTCAGGGAAGGA
ACCGGCAGTGTTACGCCAG: CCGGCAGTGTTACGCCAGA
ACCGGTCGCCTACCAAACA: CCGGTCGCCTACCAAACAA
ACCGGTCGCCTACCCCCAC: CCGGTCGCCTACCCCCACG
ACCGGTCGCCTACCCGCCC: CCGGTCGCCTACCCGCCCG
ACCGTTAACGCTCATCCCG: CCGTTAACGCTCATCCCGA
ACCGTTCCAATGAATAAGA: CCGTTCCAATGAATAAGAA
ACCGTTTTTGGGATCATCC: CCGTTTTTGGGATCATCCC
ACCTAAAGCGGAGCGTTGG: CCTAAAGCGGAGCGTTGGT
ACCTAAGCCATGCGCGCGA: CCTAAGCCATGCGCGCGAA
ACCTACGCCGGCTCCCAGA: CCTACGCCGGCTCCCAGAA
ACCTAGTTTTTGCTCTGAA: CCTAGTTTTTGCTCTGAAC
ACCTATTCATTTCTGCTAC: CCTATTCATTTCTGCTACC
ACCTGGACGTAACGATCCG: CCTGGACGTAACGATCCGA
ACCTGTCGTACGTGCGTCG: CCTGTCGTACGTGCGTCGG
ACCTGTGCCAGCCGAGACC: CCTGTGCCAGCCGAGACCG
ACCTTAGAATACCACGCTT: CCTTAGAATACCACGCTTA
ACGAACACAGGCTTTCCGA: CGAACACAGGCTTTCCGAC
ACGAACCGGTCGCCTACCA: CGAACCGGTCGCCTACCAA
ACGAACCGGTCGCCTACCC: CGAACCGGTCGCCTACCCG CGAACCGGTCGCCTACCCC
ACGAACCGGTCGCCTACCT: CGAACCGGTCGCCTACCTG
ACGAACTACAGGTAGGAAC: CGAACTACAGGTAGGAACA
ACGACGTTCTAAAACTGCC: CGACGTTCTAAAACTGCCA
ACGACTGCGAAGCCTACGA: CGACTGCGAAGCCTACGAT
ACGAGACCTAAGCCATGCG: CGAGACCTAAGCCATGCGC
ACGAGTGCCAGCCATGTGC: CGAGTGCCAGCCATGTGCG
ACGATAGCGTTCGGTGTAC: CGATAGCGTTCGGTGTACT
ACGATCCGAGCGAACTTGC: CGATCCGAGCGAACTTGCG
ACGATCGAACCAAACCCCA: CGATCGAACCAAACCCCAC
ACGCAATTTTTTTGTATTA: CGCAATTTTTTTGTATTAT
ACGCATAACTCGACAAGTC: CGCATAACTCGACAAGTCC
ACGCCAGAACATTCTCATC: CGCCAGAACATTCTCATCT
ACGCCGGCTCCCAGAATAA: CGCCGGCTCCCAGAATAAA
ACGCGCTATTGCATCGTGC: CGCGCTATTGCATCGTGCA
ACGCGTAAGCAACGCAATT: CGCGTAAGCAACGCAATTT
ACGCTCATCCCGACCACCA: CGCTCATCCCGACCACCAA
ACGCTTATAGATCAAGCAC: CGCTTATAGATCAAGCACA
ACGGCACATCTTATTACTA: CGGCACATCTTATTACTAG
ACGGCCTTAATGGGAAGTC: CGGCCTTAATGGGAAGTCT
ACGGGACGTGCGGCCGAGC: CGGGACGTGCGGCCGAGCG
ACGGGATCCGCTTCCGGCC: CGGGATCCGCTTCCGGCCA
ACGGGCGATCTCCCCTCCG: CGGGCGATCTCCCCTCCGC
ACGGGGCCCTACGGCCTTA: CGGGGCCCTACGGCCTTAA
ACGGGGGGAAGATGGCAGC: CGGGGGGAAGATGGCAGCC
ACGGTACGAACTACAGGTA: CGGTACGAACTACAGGTAG
ACGGTAGTGTGCCCATCGT: CGGTAGTGTGCCCATCGTC
ACGTAACGATCCGAGCGAA: CGTAACGATCCGAGCGAAC
ACGTAGCAACATTCGACGT: CGTAGCAACATTCGACGTA
ACGTATCCCCAAATCATTC: CGTATCCCCAAATCATTCT
ACGTCGTTCTTCCTGCAGA: CGTCGTTCTTCCTGCAGAA
ACGTGCGGCCGAGCGAGGT: CGTGCGGCCGAGCGAGGTT
ACGTGCGTCGGAGGCATGT: CGTGCGTCGGAGGCATGTT
ACGTGTTCTTCAACATCTA: CGTGTTCTTCAACATCTAA
ACGTTCGAGTCTCTTCGTC: CGTTCGAGTCTCTTCGTCT
ACGTTCTAAAACTGCCATA: CGTTCTAAAACTGCCATAA
ACTAAAGCCATGCACGGGA: CTAAAGCCATGCACGGGAC
ACTACAGGTAGGAACACGT: CTACAGGTAGGAACACGTC
ACTACATCTCGGCACGTAG: CTACATCTCGGCACGTAGC
ACTACGAGTGCCAGCCATG: CTACGAGTGCCAGCCATGT
ACTACTCCCCACAACTCGT: CTACTCCCCACAACTCGTA
ACTAGCCCACCCAGACCTA: CTAGCCCACCCAGACCTAA
ACTAGGGTTAAAGGGCAAG: CTAGGGTTAAAGGGCAAGC
ACTATAAGGGCCACAAATA: CTATAAGGGCCACAAATAG
ACTATAGGGTGTCACTTGT: CTATAGGGTGTCACTTGTT
ACTCATTGCAGACCAAATA: CTCATTGCAGACCAAATAC
ACTCCATCCGACGATCGAA: CTCCATCCGACGATCGAAC
ACTCCCCACAACTCGTATG: CTCCCCACAACTCGTATGT
ACTCGACAAGTCCCTGCCA: CTCGACAAGTCCCTGCCAA
ACTCGCGTATAAATCCTCC: CTCGCGTATAAATCCTCCA
ACTCGTATGTGTTGTGCAG: CTCGTATGTGTTGTGCAGT
ACTCTCTGATCAATCTATA: CTCTCTGATCAATCTATAC
ACTCTTCATTGGTGCTATC: CTCTTCATTGGTGCTATCC
ACTGATCTGCCGAAACGGT: CTGATCTGCCGAAACGGTA
ACTGCACCTACGCCGGCTC: CTGCACCTACGCCGGCTCC
ACTGCACTGTTCGCACCAC: CTGCACTGTTCGCACCACC
ACTGCCATAAAGCGATTCG: CTGCCATAAAGCGATTCGG
ACTGCGAAGCCTACGATAG: CTGCGAAGCCTACGATAGC
ACTGCGACGTTCGAGTCTC: CTGCGACGTTCGAGTCTCT
ACTGGGTCGGGCTGAGTCC: CTGGGTCGGGCTGAGTCCA
ACTGTCCGGGCTACTTGCG: CTGTCCGGGCTACTTGCGA
ACTGTTCGCACCACCGACG: CTGTTCGCACCACCGACGC
ACTGTTTCGTGAAATTACC: CTGTTTCGTGAAATTACCA
ACTTCCTTTAGGTCCTGGC: CTTCCTTTAGGTCCTGGCC
ACTTGCGAACCAGGAGCAG: CTTGCGAACCAGGAGCAGC
ACTTGCGAGTAGACCTTAG: CTTGCGAGTAGACCTTAGA
ACTTGTTCCGATCTGTAGA: CTTGTTCCGATCTGTAGAT
ACTTTTCGGGTCTACGACG: CTTTTCGGGTCTACGACGT
AGAAATCGATGCTCTGGGG: GAAATCGATGCTCTGGGGC
AGAACATTCTCATCTATTG: GAACATTCTCATCTATTGT
AGAAGTGGATCTGGCGAAT: GAAGTGGATCTGGCGAATA
AGAATAAAAGCCATTGGGT: GAATAAAAGCCATTGGGTA
AGAATACCACGCTTATAGA: GAATACCACGCTTATAGAT
AGAATACTATAGGGTGTCA: GAATACTATAGGGTGTCAC
AGAATCAATACAAGGTGTA: GAATCAATACAAGGTGTAG
AGAATGGTGCGTTCTACCT: GAATGGTGCGTTCTACCTG
AGACACCAGACCCATAGGT: GACACCAGACCCATAGGTG
AGACATAATATCGTCTCGA: GACATAATATCGTCTCGAA
AGACATAGGATTCCATAAA: GACATAGGATTCCATAAAC
AGACCAAATACCAAAAACT: GACCAAATACCAAAAACTG
AGACCCATAGGTGGAACGG: GACCCATAGGTGGAACGGG
AGACCGAATTACAATAAGA: GACCGAATTACAATAAGAG
AGACCTAAAGCGGAGCGTT: GACCTAAAGCGGAGCGTTG
AGACCTAAGCCATGCGCGC: GACCTAAGCCATGCGCGCG
AGACCTGTGCCAGCCGAGA: GACCTGTGCCAGCCGAGAC
AGACCTTAGAATACCACGC: GACCTTAGAATACCACGCT
AGACGAACACAGGCTTTCC: GACGAACACAGGCTTTCCG
AGACGAGACCTAAGCCATG: GACGAGACCTAAGCCATGC
AGAGAATACTATAGGGTGT: GAGAATACTATAGGGTGTC
AGAGAGAATACTATAGGGT: GAGAGAATACTATAGGGTG
AGAGCCATTGTCTTGGCCA: GAGCCATTGTCTTGGCCAT
AGAGTACTGTTTCGTGAAA: GAGTACTGTTTCGTGAAAT
AGATAAACAGGACGAACCG: GATAAACAGGACGAACCGG
AGATCAAGCACAGTACACG: GATCAAGCACAGTACACGT
AGATCAGCGTATTGCGTCT: GATCAGCGTATTGCGTCTA
AGATCCAGAGTACTGTTTC: GATCCAGAGTACTGTTTCG
AGATCCTGGCCCCCTGAAG: GATCCTGGCCCCCTGAAGA
AGATCGGGTGTTTGCACTT: GATCGGGTGTTTGCACTTT
AGATGGATGGAGCCGGAGT: GATGGATGGAGCCGGAGTT
AGATGGCAGCCGGACAGGA: GATGGCAGCCGGACAGGAT
AGCAACATTCGACGTATCC: GCAACATTCGACGTATCCC
AGCAACGCAATTTTTTTGT: GCAACGCAATTTTTTTGTA
AGCACAGTACACGTGTTCT: GCACAGTACACGTGTTCTT
AGCACCGTTTTTGGGATCA: GCACCGTTTTTGGGATCAT
AGCACTGCGACGTTCGAGT: GCACTGCGACGTTCGAGTC
AGCAGCTGATTTGAGACGA: GCAGCTGATTTGAGACGAA
AGCATAATGGAGATCCTGG: GCATAATGGAGATCCTGGC
AGCCACGCGTAAGCAACGC: GCCACGCGTAAGCAACGCA
AGCCATGCACGGGACGTGC: GCCATGCACGGGACGTGCG
AGCCATGCGCGCGAATACA: GCCATGCGCGCGAATACAG
AGCCATGTGCGAGACACCA: GCCATGTGCGAGACACCAG
AGCCATTGGGTACATTAGG: GCCATTGGGTACATTAGGC
AGCCATTGTCTTGGCCATT: GCCATTGTCTTGGCCATTC
AGCCCACCCAGACCTAAAG: GCCCACCCAGACCTAAAGC
AGCCGAGACCGAATTACAA: GCCGAGACCGAATTACAAT
AGCCGCTCAGTTCTACCGG: GCCGCTCAGTTCTACCGGC
AGCCGGACAGGATCGCAGC: GCCGGACAGGATCGCAGCA
AGCCGGAGTTTGAGCTTTT: GCCGGAGTTTGAGCTTTTT
AGCCTACGATAGCGTTCGG: GCCTACGATAGCGTTCGGT
AGCGAACTTGCGAACCAGG: GCGAACTTGCGAACCAGGA
AGCGAGGTTGTATATATTT: GCGAGGTTGTATATATTTA
AGCGATCTCGATGGGTTAC: GCGATCTCGATGGGTTACA
AGCGATTCGGCGACCCGTG: GCGATTCGGCGACCCGTGC
AGCGCAGGGGATGTTCGTA: GCGCAGGGGATGTTCGTAT
AGCGGAAGCTCACCAACTA: GCGGAAGCTCACCAACTAA
AGCGGAGCGTTGGTTGAGT: GCGGAGCGTTGGTTGAGTT
AGCGTATTGCGTCTATAAT: GCGTATTGCGTCTATAATG
AGCGTCTAGCACTGCGACG: GCGTCTAGCACTGCGACGT
AGCGTTCGGTGTACTAGGG: GCGTTCGGTGTACTAGGGT
AGCGTTGGTTGAGTTAGTA: GCGTTGGTTGAGTTAGTAA
AGCTACTCCATCCGACGAT: GCTACTCCATCCGACGATC
AGCTCACCAACTAAAGCCA: GCTCACCAACTAAAGCCAT
AGCTCTGGACGAACCGGTC: GCTCTGGACGAACCGGTCG
AGCTGATTTGAGACGAACA: GCTGATTTGAGACGAACAC
AGCTGGAAACTATAAGGGC: GCTGGAAACTATAAGGGCC
AGCTTTTTGGGGAATTGAT: GCTTTTTGGGGAATTGATT
AGGAACACGTCGTTCTTCC: GGAACACGTCGTTCTTCCT
AGGACGAACCGGTCGCCTA: GGACGAACCGGTCGCCTAC
AGGACTACGAGTGCCAGCC: GGACTACGAGTGCCAGCCA
AGGAGCAGCTGATTTGAGA: GGAGCAGCTGATTTGAGAC
AGGATACCTATTCATTTCT: GGATACCTATTCATTTCTG
AGGATCGCAGCATAATGGA: GGATCGCAGCATAATGGAG
AGGATGCCGGGATAGGGAG: GGATGCCGGGATAGGGAGC
AGGATTCCATAAACTCTTC: GGATTCCATAAACTCTTCA
AGGATTTTGAACCCGACGA: GGATTTTGAACCCGACGAA
AGGCATGTTCGGAACATTT: GGCATGTTCGGAACATTTC
AGGCGGCCTCGGTTGACGA: GGCGGCCTCGGTTGACGAA
AGGCTGTAAGATCCAGAGT: GGCTGTAAGATCCAGAGTA
AGGCTTTCCGACCTAGTTT: GGCTTTCCGACCTAGTTTT
AGGGAAGGACTACGAGTGC: GGGAAGGACTACGAGTGCC
AGGGAGATAAACAGGACGA: GGGAGATAAACAGGACGAA
AGGGAGCGTCTAGCACTGC: GGGAGCGTCTAGCACTGCG
AGGGCAAGCTGGAAACTAT: GGGCAAGCTGGAAACTATA
AGGGCCACAAATAGACGAG: GGGCCACAAATAGACGAGA
AGGGCCCACGGGGGGAAGA: GGGCCCACGGGGGGAAGAT
AGGGCCTGACCATGGGGAG: GGGCCTGACCATGGGGAGG
AGGGGAACCGTTAACGCTC: GGGGAACCGTTAACGCTCA
AGGGGATGTTCGTATAGTC: GGGGATGTTCGTATAGTCC
AGGGTGTCACTTGTTCCGA: GGGTGTCACTTGTTCCGAT
AGGGTTAAAGGGCAAGCTG: GGGTTAAAGGGCAAGCTGG
AGGTACACGACTGCGAAGC: GGTACACGACTGCGAAGCC
AGGTACCGTTCCAATGAAT: GGTACCGTTCCAATGAATA
AGGTAGGAACACGTCGTTC: GGTAGGAACACGTCGTTCT
AGGTATCTACACTCATTGC: GGTATCTACACTCATTGCA
AGGTCAGATCAGCGTATTG: GGTCAGATCAGCGTATTGC
AGGTCCTGGCCCAGTTCAA: GGTCCTGGCCCAGTTCAAT
AGGTGGAACGGGCGATCTC: GGTGGAACGGGCGATCTCC
AGGTGTAGCGGAAGCTCAC: GGTGTAGCGGAAGCTCACC
AGGTTATAGCTCTGGACGA: GGTTATAGCTCTGGACGAA
AGGTTGTATATATTTACGG: GGTTGTATATATTTACGGG
AGTAAGGTCAGATCAGCGT: GTAAGGTCAGATCAGCGTA
AGTACACGTGTTCTTCAAC: GTACACGTGTTCTTCAACA
AGTACTGTTTCGTGAAATT: GTACTGTTTCGTGAAATTA
AGTAGACCTGTGCCAGCCG: GTAGACCTGTGCCAGCCGA
AGTAGACCTTAGAATACCA: GTAGACCTTAGAATACCAC
AGTATGGAGGATACCTATT: GTATGGAGGATACCTATTC
AGTCAGTAGACCTGTGCCA: GTCAGTAGACCTGTGCCAG
AGTCCAAGGTACACGACTG: GTCCAAGGTACACGACTGC
AGTCCACACGGCACATCTT: GTCCACACGGCACATCTTA
AGTCCCTGCCAAAAAGCAC: GTCCCTGCCAAAAAGCACC
AGTCGGGTCTGCATCATCC: GTCGGGTCTGCATCATCCC
AGTCTCTTACTGCACTGTT: GTCTCTTACTGCACTGTTC
AGTCTCTTCGTCTAAACGC: GTCTCTTCGTCTAAACGCA
AGTGAGTGTAAGTATGGAG: GTGAGTGTAAGTATGGAGG
AGTGCCAGCCATGTGCGAG: GTGCCAGCCATGTGCGAGA
AGTGCTAGCGATCTCGATG: GTGCTAGCGATCTCGATGG
AGTGGATCTGGCGAATATG: GTGGATCTGGCGAATATGA
AGTGTAAGTATGGAGGATA: GTGTAAGTATGGAGGATAC
AGTGTGCCCATCGTCATCC: GTGTGCCCATCGTCATCCC
AGTGTTACGCCAGAACATT: GTGTTACGCCAGAACATTC
AGTTAGTAAGGTCAGATCA: GTTAGTAAGGTCAGATCAG
AGTTCAATCCTTTGTAGCC: GTTCAATCCTTTGTAGCCG
AGTTCATCCCGACCACCAA: GTTCATCCCGACCACCAAG
AGTTCGGCAGGTATCTACA: GTTCGGCAGGTATCTACAC
AGTTCTACCGGCAGTGTTA: GTTCTACCGGCAGTGTTAC
AGTTGAGTCGGGTCTGCAT: GTTGAGTCGGGTCTGCATC
AGTTTGAGCTTTTTGGGGA: GTTTGAGCTTTTTGGGGAA
AGTTTTTGCTCTGAACATG: GTTTTTGCTCTGAACATGT
ATAAAAGCCATTGGGTACA: TAAAAGCCATTGGGTACAT
ATAAACAGGACGAACCGGT: TAAACAGGACGAACCGGTC
ATAAACTCTTCATTGGTGC: TAAACTCTTCATTGGTGCT
ATAAAGCGATTCGGCGACC: TAAAGCGATTCGGCGACCC
ATAAATCCTCCACTCTCTG: TAAATCCTCCACTCTCTGA
ATAACTCGACAAGTCCCTG: TAACTCGACAAGTCCCTGC
ATAAGAATCAATACAAGGT: TAAGAATCAATACAAGGTG
ATAAGAGCCATTGTCTTGG: TAAGAGCCATTGTCTTGGC
ATAAGGGCCACAAATAGAC: TAAGGGCCACAAATAGACG
ATAATATCGTCTCGAACTG: TAATATCGTCTCGAACTGC
ATAATGGAGATCCTGGCCC: TAATGGAGATCCTGGCCCC
ATAATGTGGCTAAAAGATC: TAATGTGGCTAAAAGATCG
ATACAAGGTGTAGCGGAAG: TACAAGGTGTAGCGGAAGC
ATACACCAAAAGCCACGCG: TACACCAAAAGCCACGCGT
ATACAGGTACCGTTCCAAT: TACAGGTACCGTTCCAATG
ATACCAAAAACTGTCCGGG: TACCAAAAACTGTCCGGGC
ATACCACGCTTATAGATCA: TACCACGCTTATAGATCAA
ATACCTATTCATTTCTGCT: TACCTATTCATTTCTGCTA
ATACTATAGGGTGTCACTT: TACTATAGGGTGTCACTTG
ATAGACGAGACCTAAGCCA: TAGACGAGACCTAAGCCAT
ATAGATCAAGCACAGTACA: TAGATCAAGCACAGTACAC
ATAGCGTTCGGTGTACTAG: TAGCGTTCGGTGTACTAGG
ATAGCTCTGGACGAACCGG: TAGCTCTGGACGAACCGGT
ATAGGATTCCATAAACTCT: TAGGATTCCATAAACTCTT
ATAGGGAGCGTCTAGCACT: TAGGGAGCGTCTAGCACTG
ATAGGGTGTCACTTGTTCC: TAGGGTGTCACTTGTTCCG
ATAGGTGGAACGGGCGATC: TAGGTGGAACGGGCGATCT
ATAGTCCAAGGTACACGAC: TAGTCCAAGGTACACGACT
ATAGTGAGTGTAAGTATGG: TAGTGAGTGTAAGTATGGA
ATAGTTGAGTCGGGTCTGC: TAGTTGAGTCGGGTCTGCA
ATATATTTACGGGGCCCTA: TATATTTACGGGGCCCTAC
ATATCGTCTCGAACTGCAC: TATCGTCTCGAACTGCACC
ATATGAGAAATCGATGCTC: TATGAGAAATCGATGCTCT
ATATTTACGGGGCCCTACG: TATTTACGGGGCCCTACGG
ATCAAGCACAGTACACGTG: TCAAGCACAGTACACGTGT
ATCAATACAAGGTGTAGCG: TCAATACAAGGTGTAGCGG
ATCAATCTATACACCAAAA: TCAATCTATACACCAAAAG
ATCAGCGTATTGCGTCTAT: TCAGCGTATTGCGTCTATA
ATCATCCCCTCACTGATCT: TCATCCCCTCACTGATCTG
ATCATCCCGACCACCAAGG: TCATCCCGACCACCAAGGA
ATCATTCTTTTGAAGGATG: TCATTCTTTTGAAGGATGC
ATCCAGAGTACTGTTTCGT: TCCAGAGTACTGTTTCGTG
ATCCCCAAATCATTCTTTT: TCCCCAAATCATTCTTTTG
ATCCCCTCACTGATCTGCC: TCCCCTCACTGATCTGCCG
ATCCCGACCACCAAGGATT: TCCCGACCACCAAGGATTT
ATCCCGACCACCAAGGCGG: TCCCGACCACCAAGGCGGC
ATCCCGACCACCAAGGGAG: TCCCGACCACCAAGGGAGA
ATCCCGACCACCAAGGTTA: TCCCGACCACCAAGGTTAT
ATCCCTAATGTACAGGGCC: TCCCTAATGTACAGGGCCT
ATCCGACGATCGAACCAAA: TCCGACGATCGAACCAAAC
ATCCGAGCGAACTTGCGAA: TCCGAGCGAACTTGCGAAC
ATCCGCTTCCGGCCAAATT: TCCGCTTCCGGCCAAATTT
ATCCTCCACTCTCTGATCA: TCCTCCACTCTCTGATCAA
ATCCTGGCCCCCTGAAGAC: TCCTGGCCCCCTGAAGACA
ATCCTTTGTAGCCGCTCAG: TCCTTTGTAGCCGCTCAGT
ATCGAACCAAACCCCACCG: TCGAACCAAACCCCACCGA
ATCGATGCTCTGGGGCCAC: TCGATGCTCTGGGGCCACT
ATCGCAGCATAATGGAGAT: TCGCAGCATAATGGAGATC
ATCGGGTGTTTGCACTTTT: TCGGGTGTTTGCACTTTTC
ATCGTCATCCCGACCACCA: TCGTCATCCCGACCACCAA
ATCGTCTCGAACTGCACCT: TCGTCTCGAACTGCACCTA
ATCGTGCAGGGCCCACGGG: TCGTGCAGGGCCCACGGGG
ATCTAACCCCGCGCCTGGT: TCTAACCCCGCGCCTGGTT
ATCTACACTCATTGCAGAC: TCTACACTCATTGCAGACC
ATCTATACACCAAAAGCCA: TCTATACACCAAAAGCCAC
ATCTATTGTAGCTACTCCA: TCTATTGTAGCTACTCCAT
ATCTCCCCTCCGCATTGGC: TCTCCCCTCCGCATTGGCT
ATCTCGATGGGTTACAATT: TCTCGATGGGTTACAATTG
ATCTCGGCACGTAGCAACA: TCTCGGCACGTAGCAACAT
ATCTGCCGAAACGGTAGTG: TCTGCCGAAACGGTAGTGT
ATCTGGCGAATATGAGAAA: TCTGGCGAATATGAGAAAT
ATCTGTAGATGGATGGAGC: TCTGTAGATGGATGGAGCC
ATCTTATTACTAGCCCACC: TCTTATTACTAGCCCACCC
ATGAATAAGAATCAATACA: TGAATAAGAATCAATACAA
ATGAGAAATCGATGCTCTG: TGAGAAATCGATGCTCTGG
ATGCACATAGTTGAGTCGG: TGCACATAGTTGAGTCGGG
ATGCACGGGACGTGCGGCC: TGCACGGGACGTGCGGCCG
ATGCCGGGATAGGGAGCGT: TGCCGGGATAGGGAGCGTC
ATGCGCGCGAATACAGGTA: TGCGCGCGAATACAGGTAC
ATGCTCTGGGGCCACTTCC: TGCTCTGGGGCCACTTCCT
ATGGAGATCCTGGCCCCCT: TGGAGATCCTGGCCCCCTG
ATGGAGCCGGAGTTTGAGC: TGGAGCCGGAGTTTGAGCT
ATGGAGGATACCTATTCAT: TGGAGGATACCTATTCATT
ATGGATGGAGCCGGAGTTT: TGGATGGAGCCGGAGTTTG
ATGGCAGCCGGACAGGATC: TGGCAGCCGGACAGGATCG
ATGGGAAGTCTCTTACTGC: TGGGAAGTCTCTTACTGCA
ATGGGGAGGGGAACCGTTA: TGGGGAGGGGAACCGTTAA
ATGGGTTACAATTGTTTAT: TGGGTTACAATTGTTTATG
ATGGTGCGTTCTACCTGTC: TGGTGCGTTCTACCTGTCG
ATGTACAGGGCCTGACCAT: TGTACAGGGCCTGACCATG
ATGTACTACTCCCCACAAC: TGTACTACTCCCCACAACT
ATGTCTTCTCCCCCGGCAT: TGTCTTCTCCCCCGGCATG
ATGTGCGAGACACCAGACC: TGTGCGAGACACCAGACCC
ATGTGGCTAAAAGATCGGG: TGTGGCTAAAAGATCGGGT
ATGTGTTGTGCAGTTCGGC: TGTGTTGTGCAGTTCGGCA
ATGTTCAAAAAGACATAGG: TGTTCAAAAAGACATAGGA
ATGTTCGGAACATTTCTGG: TGTTCGGAACATTTCTGGG
ATGTTCGTATAGTCCAAGG: TGTTCGTATAGTCCAAGGT
ATGTTGCGCCGCGTTTCAC: TGTTGCGCCGCGTTTCACG
ATTACAATAAGAGCCATTG: TTACAATAAGAGCCATTGT
ATTACCAGTGCTAGCGATC: TTACCAGTGCTAGCGATCT
ATTACTAGCCCACCCAGAC: TTACTAGCCCACCCAGACC
ATTAGGCTGTAAGATCCAG: TTAGGCTGTAAGATCCAGA
ATTAGTCAGTAGACCTGTG: TTAGTCAGTAGACCTGTGC
ATTATTGCGTTATTTATGT: TTATTGCGTTATTTATGTT
ATTCATTTCTGCTACCTGG: TTCATTTCTGCTACCTGGA
ATTCCATAAACTCTTCATT: TTCCATAAACTCTTCATTG
ATTCCCGAATAGTGAGTGT: TTCCCGAATAGTGAGTGTA
ATTCCTCAGGGAAGGACTA: TTCCTCAGGGAAGGACTAC
ATTCGACGTATCCCCAAAT: TTCGACGTATCCCCAAATC
ATTCGGCGACCCGTGCTCG: TTCGGCGACCCGTGCTCGG
ATTCTCATCTATTGTAGCT: TTCTCATCTATTGTAGCTA
ATTCTTTTGAAGGATGCCG: TTCTTTTGAAGGATGCCGG
ATTGATTGCAACTGGGTCG: TTGATTGCAACTGGGTCGG
ATTGCAACTGGGTCGGGCT: TTGCAACTGGGTCGGGCTG
ATTGCAGACCAAATACCAA: TTGCAGACCAAATACCAAA
ATTGCATCGTGCAGGGCCC: TTGCATCGTGCAGGGCCCA
ATTGCGTCTATAATGTGGC: TTGCGTCTATAATGTGGCT
ATTGCGTTATTTATGTTCA: TTGCGTTATTTATGTTCAA
ATTGGCTCACTACATCTCG: TTGGCTCACTACATCTCGG
ATTGGGTACATTAGGCTGT: TTGGGTACATTAGGCTGTA
ATTGGTGCTATCCCTAATG: TTGGTGCTATCCCTAATGT
ATTGTAGCTACTCCATCCG: TTGTAGCTACTCCATCCGA
ATTGTCTTGGCCATTCCCG: TTGTCTTGGCCATTCCCGA
ATTGTTTATGTTGCGCCGC: TTGTTTATGTTGCGCCGCG
ATTTACGGGGCCCTACGGC: TTTACGGGGCCCTACGGCC
ATTTATGTTCAAAAAGACA: TTTATGTTCAAAAAGACAT
ATTTCTGCTACCTGGACGT: TTTCTGCTACCTGGACGTA
ATTTCTGGGAGAAGTGGAT: TTTCTGGGAGAAGTGGATC
ATTTGAGACGAACACAGGC: TTTGAGACGAACACAGGCT
ATTTGGAAGCGCAGGGGAT: TTTGGAAGCGCAGGGGATG
ATTTTGAACCCGACGAACC: TTTTGAACCCGACGAACCG
ATTTTTTTGTATTATTGCG: TTTTTTTGTATTATTGCGT
CAAAAACTGTCCGGGCTAC: AAAAACTGTCCGGGCTACT
CAAAAAGACATAGGATTCC: AAAAAGACATAGGATTCCA
CAAAAAGCACCGTTTTTGG: AAAAAGCACCGTTTTTGGG
CAAAAGCCACGCGTAAGCA: AAAAGCCACGCGTAAGCAA
CAAACAACTCGCGTATAAA: AAACAACTCGCGTATAAAT
CAAACCCCACCGATTCCTC: AAACCCCACCGATTCCTCA
CAAATACCAAAAACTGTCC: AAATACCAAAAACTGTCCG
CAAATAGACGAGACCTAAG: AAATAGACGAGACCTAAGC
CAAATCATTCTTTTGAAGG: AAATCATTCTTTTGAAGGA
CAAATTTGGAAGCGCAGGG: AAATTTGGAAGCGCAGGGG
CAACATCTAACCCCGCGCC: AACATCTAACCCCGCGCCT
CAACATTCGACGTATCCCC: AACATTCGACGTATCCCCA
CAACGCAATTTTTTTGTAT: AACGCAATTTTTTTGTATT
CAACTAAAGCCATGCACGG: AACTAAAGCCATGCACGGG
CAACTCGCGTATAAATCCT: AACTCGCGTATAAATCCTC
CAACTCGTATGTGTTGTGC: AACTCGTATGTGTTGTGCA
CAACTGGGTCGGGCTGAGT: AACTGGGTCGGGCTGAGTC
CAAGCACAGTACACGTGTT: AAGCACAGTACACGTGTTC
CAAGCTGGAAACTATAAGG: AAGCTGGAAACTATAAGGG
CAAGGATTTTGAACCCGAC: AAGGATTTTGAACCCGACG
CAAGGCGGCCTCGGTTGAC: AAGGCGGCCTCGGTTGACG
CAAGGGAGATAAACAGGAC: AAGGGAGATAAACAGGACG
CAAGGTACACGACTGCGAA: AAGGTACACGACTGCGAAG
CAAGGTGTAGCGGAAGCTC: AAGGTGTAGCGGAAGCTCA
CAAGGTTATAGCTCTGGAC: AAGGTTATAGCTCTGGACG
CAAGTCCCTGCCAAAAAGC: AAGTCCCTGCCAAAAAGCA
CAATAAGAGCCATTGTCTT: AATAAGAGCCATTGTCTTG
CAATACAAGGTGTAGCGGA: AATACAAGGTGTAGCGGAA
CAATCCTTTGTAGCCGCTC: AATCCTTTGTAGCCGCTCA
CAATCTATACACCAAAAGC: AATCTATACACCAAAAGCC
CAATGAATAAGAATCAATA: AATGAATAAGAATCAATAC
CAATTGTTTATGTTGCGCC: AATTGTTTATGTTGCGCCG
CAATTTTTTTGTATTATTG: AATTTTTTTGTATTATTGC
CACAAATAGACGAGACCTA: ACAAATAGACGAGACCTAA
CACAACTCGTATGTGTTGT: ACAACTCGTATGTGTTGTG
CACACGGCACATCTTATTA: ACACGGCACATCTTATTAC
CACAGGCTTTCCGACCTAG: ACAGGCTTTCCGACCTAGT
CACAGTACACGTGTTCTTC: ACAGTACACGTGTTCTTCA
CACATAGTTGAGTCGGGTC: ACATAGTTGAGTCGGGTCT
CACATCTTATTACTAGCCC: ACATCTTATTACTAGCCCA
CACCAAAAGCCACGCGTAA: ACCAAAAGCCACGCGTAAG
CACCAACTAAAGCCATGCA: ACCAACTAAAGCCATGCAC
CACCAAGGATTTTGAACCC: ACCAAGGATTTTGAACCCG
CACCAAGGCGGCCTCGGTT: ACCAAGGCGGCCTCGGTTG
CACCAAGGGAGATAAACAG: ACCAAGGGAGATAAACAGG
CACCAAGGTTATAGCTCTG: ACCAAGGTTATAGCTCTGG
CACCACCGACGCGCTATTG: ACCACCGACGCGCTATTGC
CACCAGACCCATAGGTGGA: ACCAGACCCATAGGTGGAA
CACCCAGACCTAAAGCGGA: ACCCAGACCTAAAGCGGAG
CACCGACGCGCTATTGCAT: ACCGACGCGCTATTGCATC
CACCGATTCCTCAGGGAAG: ACCGATTCCTCAGGGAAGG
CACCGTTTTTGGGATCATC: ACCGTTTTTGGGATCATCC
CACCTACGCCGGCTCCCAG: ACCTACGCCGGCTCCCAGA
CACGACTGCGAAGCCTACG: ACGACTGCGAAGCCTACGA
CACGCGTAAGCAACGCAAT: ACGCGTAAGCAACGCAATT
CACGCTTATAGATCAAGCA: ACGCTTATAGATCAAGCAC
CACGGCACATCTTATTACT: ACGGCACATCTTATTACTA
CACGGGACGTGCGGCCGAG: ACGGGACGTGCGGCCGAGC
CACGGGATCCGCTTCCGGC: ACGGGATCCGCTTCCGGCC
CACGGGGGGAAGATGGCAG: ACGGGGGGAAGATGGCAGC
CACGGTACGAACTACAGGT: ACGGTACGAACTACAGGTA
CACGTAGCAACATTCGACG: ACGTAGCAACATTCGACGT
CACGTCGTTCTTCCTGCAG: ACGTCGTTCTTCCTGCAGA
CACGTGTTCTTCAACATCT: ACGTGTTCTTCAACATCTA
CACTACATCTCGGCACGTA: ACTACATCTCGGCACGTAG
CACTCATTGCAGACCAAAT: ACTCATTGCAGACCAAATA
CACTCTCTGATCAATCTAT: ACTCTCTGATCAATCTATA
CACTGATCTGCCGAAACGG: ACTGATCTGCCGAAACGGT
CACTGCGACGTTCGAGTCT: ACTGCGACGTTCGAGTCTC
CACTGTTCGCACCACCGAC: ACTGTTCGCACCACCGACG
CACTTCCTTTAGGTCCTGG: ACTTCCTTTAGGTCCTGGC
CACTTGTTCCGATCTGTAG: ACTTGTTCCGATCTGTAGA
CACTTTTCGGGTCTACGAC: ACTTTTCGGGTCTACGACG
CAGAACATTCTCATCTATT: AGAACATTCTCATCTATTG
CAGAATAAAAGCCATTGGG: AGAATAAAAGCCATTGGGT
CAGAATGGTGCGTTCTACC: AGAATGGTGCGTTCTACCT
CAGACCAAATACCAAAAAC: AGACCAAATACCAAAAACT
CAGACCCATAGGTGGAACG: AGACCCATAGGTGGAACGG
CAGACCTAAAGCGGAGCGT: AGACCTAAAGCGGAGCGTT
CAGAGTACTGTTTCGTGAA: AGAGTACTGTTTCGTGAAA
CAGATCAGCGTATTGCGTC: AGATCAGCGTATTGCGTCT
CAGCATAATGGAGATCCTG: AGCATAATGGAGATCCTGG
CAGCCATGTGCGAGACACC: AGCCATGTGCGAGACACCA
CAGCCGAGACCGAATTACA: AGCCGAGACCGAATTACAA
CAGCCGGACAGGATCGCAG: AGCCGGACAGGATCGCAGC
CAGCGTATTGCGTCTATAA: AGCGTATTGCGTCTATAAT
CAGCTGATTTGAGACGAAC: AGCTGATTTGAGACGAACA
CAGGACGAACCGGTCGCCT: AGGACGAACCGGTCGCCTA
CAGGAGCAGCTGATTTGAG: AGGAGCAGCTGATTTGAGA
CAGGATCGCAGCATAATGG: AGGATCGCAGCATAATGGA
CAGGCTTTCCGACCTAGTT: AGGCTTTCCGACCTAGTTT
CAGGGAAGGACTACGAGTG: AGGGAAGGACTACGAGTGC
CAGGGCCCACGGGGGGAAG: AGGGCCCACGGGGGGAAGA
CAGGGCCTGACCATGGGGA: AGGGCCTGACCATGGGGAG
CAGGGGATGTTCGTATAGT: AGGGGATGTTCGTATAGTC
CAGGTACCGTTCCAATGAA: AGGTACCGTTCCAATGAAT
CAGGTAGGAACACGTCGTT: AGGTAGGAACACGTCGTTC
CAGGTATCTACACTCATTG: AGGTATCTACACTCATTGC
CAGTACACGTGTTCTTCAA: AGTACACGTGTTCTTCAAC
CAGTAGACCTGTGCCAGCC: AGTAGACCTGTGCCAGCCG
CAGTGCTAGCGATCTCGAT: AGTGCTAGCGATCTCGATG
CAGTGTTACGCCAGAACAT: AGTGTTACGCCAGAACATT
CAGTTCAATCCTTTGTAGC: AGTTCAATCCTTTGTAGCC
CAGTTCGGCAGGTATCTAC: AGTTCGGCAGGTATCTACA
CAGTTCTACCGGCAGTGTT: AGTTCTACCGGCAGTGTTA
CATAAACTCTTCATTGGTG: ATAAACTCTTCATTGGTGC
CATAAAGCGATTCGGCGAC: ATAAAGCGATTCGGCGACC
CATAACTCGACAAGTCCCT: ATAACTCGACAAGTCCCTG
CATAATATCGTCTCGAACT: ATAATATCGTCTCGAACTG
CATAATGGAGATCCTGGCC: ATAATGGAGATCCTGGCCC
CATAGGATTCCATAAACTC: ATAGGATTCCATAAACTCT
CATAGGTGGAACGGGCGAT: ATAGGTGGAACGGGCGATC
CATAGTTGAGTCGGGTCTG: ATAGTTGAGTCGGGTCTGC
CATCATCCCCTCACTGATC: ATCATCCCCTCACTGATCT
CATCCCCTCACTGATCTGC: ATCCCCTCACTGATCTGCC
CATCCCGACCACCAAGGAT: ATCCCGACCACCAAGGATT
CATCCCGACCACCAAGGCG: ATCCCGACCACCAAGGCGG
CATCCCGACCACCAAGGGA: ATCCCGACCACCAAGGGAG
CATCCCGACCACCAAGGTT: ATCCCGACCACCAAGGTTA
CATCCGACGATCGAACCAA: ATCCGACGATCGAACCAAA
CATCGTCATCCCGACCACC: ATCGTCATCCCGACCACCA
CATCGTGCAGGGCCCACGG: ATCGTGCAGGGCCCACGGG
CATCTAACCCCGCGCCTGG: ATCTAACCCCGCGCCTGGT
CATCTATTGTAGCTACTCC: ATCTATTGTAGCTACTCCA
CATCTCGGCACGTAGCAAC: ATCTCGGCACGTAGCAACA
CATCTTATTACTAGCCCAC: ATCTTATTACTAGCCCACC
CATGCACATAGTTGAGTCG: ATGCACATAGTTGAGTCGG
CATGCACGGGACGTGCGGC: ATGCACGGGACGTGCGGCC
CATGCGCGCGAATACAGGT: ATGCGCGCGAATACAGGTA
CATGGGGAGGGGAACCGTT: ATGGGGAGGGGAACCGTTA
CATGTACTACTCCCCACAA: ATGTACTACTCCCCACAAC
CATGTGCGAGACACCAGAC: ATGTGCGAGACACCAGACC
CATGTTCGGAACATTTCTG: ATGTTCGGAACATTTCTGG
CATTAGGCTGTAAGATCCA: ATTAGGCTGTAAGATCCAG
CATTCCCGAATAGTGAGTG: ATTCCCGAATAGTGAGTGT
CATTCGACGTATCCCCAAA: ATTCGACGTATCCCCAAAT
CATTCTCATCTATTGTAGC: ATTCTCATCTATTGTAGCT
CATTCTTTTGAAGGATGCC: ATTCTTTTGAAGGATGCCG
CATTGCAGACCAAATACCA: ATTGCAGACCAAATACCAA
CATTGGCTCACTACATCTC: ATTGGCTCACTACATCTCG
CATTGGGTACATTAGGCTG: ATTGGGTACATTAGGCTGT
CATTGGTGCTATCCCTAAT: ATTGGTGCTATCCCTAATG
CATTGTCTTGGCCATTCCC: ATTGTCTTGGCCATTCCCG
CATTTCTGCTACCTGGACG: ATTTCTGCTACCTGGACGT
CATTTCTGGGAGAAGTGGA: ATTTCTGGGAGAAGTGGAT
CCAAAAACTGTCCGGGCTA: CAAAAACTGTCCGGGCTAC
CCAAAAAGCACCGTTTTTG: CAAAAAGCACCGTTTTTGG
CCAAAAGCCACGCGTAAGC: CAAAAGCCACGCGTAAGCA
CCAAACAACTCGCGTATAA: CAAACAACTCGCGTATAAA
CCAAACCCCACCGATTCCT: CAAACCCCACCGATTCCTC
CCAAATACCAAAAACTGTC: CAAATACCAAAAACTGTCC
CCAAATCATTCTTTTGAAG: CAAATCATTCTTTTGAAGG
CCAAATTTGGAAGCGCAGG: CAAATTTGGAAGCGCAGGG
CCAACTAAAGCCATGCACG: CAACTAAAGCCATGCACGG
CCAAGGATTTTGAACCCGA: CAAGGATTTTGAACCCGAC
CCAAGGCGGCCTCGGTTGA: CAAGGCGGCCTCGGTTGAC
CCAAGGGAGATAAACAGGA: CAAGGGAGATAAACAGGAC
CCAAGGTACACGACTGCGA: CAAGGTACACGACTGCGAA
CCAAGGTTATAGCTCTGGA: CAAGGTTATAGCTCTGGAC
CCAATGAATAAGAATCAAT: CAATGAATAAGAATCAATA
CCACAAATAGACGAGACCT: CACAAATAGACGAGACCTA
CCACAACTCGTATGTGTTG: CACAACTCGTATGTGTTGT
CCACACGGCACATCTTATT: CACACGGCACATCTTATTA
CCACCAAGGATTTTGAACC: CACCAAGGATTTTGAACCC
CCACCAAGGCGGCCTCGGT: CACCAAGGCGGCCTCGGTT
CCACCAAGGGAGATAAACA: CACCAAGGGAGATAAACAG
CCACCAAGGTTATAGCTCT: CACCAAGGTTATAGCTCTG
CCACCCAGACCTAAAGCGG: CACCCAGACCTAAAGCGGA
CCACCGACGCGCTATTGCA: CACCGACGCGCTATTGCAT
CCACCGATTCCTCAGGGAA: CACCGATTCCTCAGGGAAG
CCACGCGTAAGCAACGCAA: CACGCGTAAGCAACGCAAT
CCACGCTTATAGATCAAGC: CACGCTTATAGATCAAGCA
CCACGGGATCCGCTTCCGG: CACGGGATCCGCTTCCGGC
CCACGGGGGGAAGATGGCA: CACGGGGGGAAGATGGCAG
CCACTCTCTGATCAATCTA: CACTCTCTGATCAATCTAT
CCACTTCCTTTAGGTCCTG: CACTTCCTTTAGGTCCTGG
CCAGAACATTCTCATCTAT: CAGAACATTCTCATCTATT
CCAGAATAAAAGCCATTGG: CAGAATAAAAGCCATTGGG
CCAGACCCATAGGTGGAAC: CAGACCCATAGGTGGAACG
CCAGACCTAAAGCGGAGCG: CAGACCTAAAGCGGAGCGT
CCAGAGTACTGTTTCGTGA: CAGAGTACTGTTTCGTGAA
CCAGCCATGTGCGAGACAC: CAGCCATGTGCGAGACACC
CCAGCCGAGACCGAATTAC: CAGCCGAGACCGAATTACA
CCAGGAGCAGCTGATTTGA: CAGGAGCAGCTGATTTGAG
CCAGTGCTAGCGATCTCGA: CAGTGCTAGCGATCTCGAT
CCAGTTCAATCCTTTGTAG: CAGTTCAATCCTTTGTAGC
CCATAAACTCTTCATTGGT: CATAAACTCTTCATTGGTG
CCATAAAGCGATTCGGCGA: CATAAAGCGATTCGGCGAC
CCATAGGTGGAACGGGCGA: CATAGGTGGAACGGGCGAT
CCATCCGACGATCGAACCA: CATCCGACGATCGAACCAA
CCATCGTCATCCCGACCAC: CATCGTCATCCCGACCACC
CCATGCACGGGACGTGCGG: CATGCACGGGACGTGCGGC
CCATGCGCGCGAATACAGG: CATGCGCGCGAATACAGGT
CCATGGGGAGGGGAACCGT: CATGGGGAGGGGAACCGTT
CCATGTGCGAGACACCAGA: CATGTGCGAGACACCAGAC
CCATTCCCGAATAGTGAGT: CATTCCCGAATAGTGAGTG
CCATTGGGTACATTAGGCT: CATTGGGTACATTAGGCTG
CCATTGTCTTGGCCATTCC: CATTGTCTTGGCCATTCCC
CCCAAATCATTCTTTTGAA: CCAAATCATTCTTTTGAAG
CCCACAACTCGTATGTGTT: CCACAACTCGTATGTGTTG
CCCACCCAGACCTAAAGCG: CCACCCAGACCTAAAGCGG
CCCACCGATTCCTCAGGGA: CCACCGATTCCTCAGGGAA
CCCACGGGATCCGCTTCCG: CCACGGGATCCGCTTCCGG
CCCACGGGGGGAAGATGGC: CCACGGGGGGAAGATGGCA
CCCAGAATAAAAGCCATTG: CCAGAATAAAAGCCATTGG
CCCAGACCTAAAGCGGAGC: CCAGACCTAAAGCGGAGCG
CCCAGTTCAATCCTTTGTA: CCAGTTCAATCCTTTGTAG
CCCATAGGTGGAACGGGCG: CCATAGGTGGAACGGGCGA
CCCATCGTCATCCCGACCA: CCATCGTCATCCCGACCAC
CCCCAAATCATTCTTTTGA: CCCAAATCATTCTTTTGAA
CCCCACAACTCGTATGTGT: CCCACAACTCGTATGTGTT
CCCCACCGATTCCTCAGGG: CCCACCGATTCCTCAGGGA
CCCCACGGGATCCGCTTCC: CCCACGGGATCCGCTTCCG
CCCCCACGGGATCCGCTTC: CCCCACGGGATCCGCTTCC
CCCCCGGCATGCACATAGT: CCCCGGCATGCACATAGTT
CCCCCTGAAGACATAATAT: CCCCTGAAGACATAATATC
CCCCGCGCCTGGTTTGATG: CCCGCGCCTGGTTTGATGT
CCCCGGCATGCACATAGTT: CCCGGCATGCACATAGTTG
CCCCTCACTGATCTGCCGA: CCCTCACTGATCTGCCGAA
CCCCTCCGCATTGGCTCAC: CCCTCCGCATTGGCTCACT
CCCCTGAAGACATAATATC: CCCTGAAGACATAATATCG
CCCGAATAGTGAGTGTAAG: CCGAATAGTGAGTGTAAGT
CCCGACCACCAAGGATTTT: CCGACCACCAAGGATTTTG
CCCGACCACCAAGGCGGCC: CCGACCACCAAGGCGGCCT
CCCGACCACCAAGGGAGAT: CCGACCACCAAGGGAGATA
CCCGACCACCAAGGTTATA: CCGACCACCAAGGTTATAG
CCCGACGAACCGGTCGCCT: CCGACGAACCGGTCGCCTA
CCCGCCCGCTAAGAGAGAA: CCGCCCGCTAAGAGAGAAT
CCCGCGCCTGGTTTGATGT: CCGCGCCTGGTTTGATGTC
CCCGCTAAGAGAGAATACT: CCGCTAAGAGAGAATACTA
CCCGGCATGCACATAGTTG: CCGGCATGCACATAGTTGA
CCCGTGCTCGGGATTAGTC: CCGTGCTCGGGATTAGTCA
CCCTAATGTACAGGGCCTG: CCTAATGTACAGGGCCTGA
CCCTACGGCCTTAATGGGA: CCTACGGCCTTAATGGGAA
CCCTCACTGATCTGCCGAA: CCTCACTGATCTGCCGAAA
CCCTCCGCATTGGCTCACT: CCTCCGCATTGGCTCACTA
CCCTGAAGACATAATATCG: CCTGAAGACATAATATCGT
CCCTGCCAAAAAGCACCGT: CCTGCCAAAAAGCACCGTT
CCGAAACGGTAGTGTGCCC: CGAAACGGTAGTGTGCCCA
CCGAATAGTGAGTGTAAGT: CGAATAGTGAGTGTAAGTA
CCGAATTACAATAAGAGCC: CGAATTACAATAAGAGCCA
CCGACCACCAAGGATTTTG: CGACCACCAAGGATTTTGA
CCGACCACCAAGGCGGCCT: CGACCACCAAGGCGGCCTC
CCGACCACCAAGGGAGATA: CGACCACCAAGGGAGATAA
CCGACCACCAAGGTTATAG: CGACCACCAAGGTTATAGC
CCGACCTAGTTTTTGCTCT: CGACCTAGTTTTTGCTCTG
CCGACGAACCGGTCGCCTA: CGACGAACCGGTCGCCTAC
CCGACGATCGAACCAAACC: CGACGATCGAACCAAACCC
CCGACGCGCTATTGCATCG: CGACGCGCTATTGCATCGT
CCGAGACCGAATTACAATA: CGAGACCGAATTACAATAA
CCGAGCGAACTTGCGAACC: CGAGCGAACTTGCGAACCA
CCGAGCGAGGTTGTATATA: CGAGCGAGGTTGTATATAT
CCGATCTGTAGATGGATGG: CGATCTGTAGATGGATGGA
CCGATTCCTCAGGGAAGGA: CGATTCCTCAGGGAAGGAC
CCGCATTGGCTCACTACAT: CGCATTGGCTCACTACATC
CCGCCCGCTAAGAGAGAAT: CGCCCGCTAAGAGAGAATA
CCGCGCCTGGTTTGATGTC: CGCGCCTGGTTTGATGTCT
CCGCGTTTCACGGTACGAA: CGCGTTTCACGGTACGAAC
CCGCTAAGAGAGAATACTA: CGCTAAGAGAGAATACTAT
CCGCTCAGTTCTACCGGCA: CGCTCAGTTCTACCGGCAG
CCGCTTCCGGCCAAATTTG: CGCTTCCGGCCAAATTTGG
CCGGACAGGATCGCAGCAT: CGGACAGGATCGCAGCATA
CCGGAGTTTGAGCTTTTTG: CGGAGTTTGAGCTTTTTGG
CCGGCAGTGTTACGCCAGA: CGGCAGTGTTACGCCAGAA
CCGGCATGCACATAGTTGA: CGGCATGCACATAGTTGAG
CCGGCCAAATTTGGAAGCG: CGGCCAAATTTGGAAGCGC
CCGGCTCCCAGAATAAAAG: CGGCTCCCAGAATAAAAGC
CCGGGATAGGGAGCGTCTA: CGGGATAGGGAGCGTCTAG
CCGGGCTACTTGCGAGTAG: CGGGCTACTTGCGAGTAGA
CCGGTCGCCTACCAAACAA: CGGTCGCCTACCAAACAAC
CCGGTCGCCTACCCCCACG: CGGTCGCCTACCCCCACGG
CCGGTCGCCTACCCGCCCG: CGGTCGCCTACCCGCCCGC
CCGTGCTCGGGATTAGTCA: CGTGCTCGGGATTAGTCAG
CCGTTAACGCTCATCCCGA: CGTTAACGCTCATCCCGAC
CCGTTCCAATGAATAAGAA: CGTTCCAATGAATAAGAAT
CCGTTTTTGGGATCATCCC: CGTTTTTGGGATCATCCCG
CCTAAAGCGGAGCGTTGGT: CTAAAGCGGAGCGTTGGTT
CCTAAGCCATGCGCGCGAA: CTAAGCCATGCGCGCGAAT
CCTAATGTACAGGGCCTGA: CTAATGTACAGGGCCTGAC
CCTACCAAACAACTCGCGT: CTACCAAACAACTCGCGTA
CCTACCCCCACGGGATCCG: CTACCCCCACGGGATCCGC
CCTACCCGCCCGCTAAGAG: CTACCCGCCCGCTAAGAGA
CCTACGATAGCGTTCGGTG: CTACGATAGCGTTCGGTGT
CCTACGCCGGCTCCCAGAA: CTACGCCGGCTCCCAGAAT
CCTACGGCCTTAATGGGAA: CTACGGCCTTAATGGGAAG
CCTAGTTTTTGCTCTGAAC: CTAGTTTTTGCTCTGAACA
CCTATTCATTTCTGCTACC: CTATTCATTTCTGCTACCT
CCTCACTGATCTGCCGAAA: CTCACTGATCTGCCGAAAC
CCTCAGGGAAGGACTACGA: CTCAGGGAAGGACTACGAG
CCTCCACTCTCTGATCAAT: CTCCACTCTCTGATCAATC
CCTCCGCATTGGCTCACTA: CTCCGCATTGGCTCACTAC
CCTCGGTTGACGAACCGGT: CTCGGTTGACGAACCGGTC
CCTGAAGACATAATATCGT: CTGAAGACATAATATCGTC
CCTGACCATGGGGAGGGGA: CTGACCATGGGGAGGGGAA
CCTGCAGAATGGTGCGTTC: CTGCAGAATGGTGCGTTCT
CCTGCCAAAAAGCACCGTT: CTGCCAAAAAGCACCGTTT
CCTGGACGTAACGATCCGA: CTGGACGTAACGATCCGAG
CCTGGCCCAGTTCAATCCT: CTGGCCCAGTTCAATCCTT
CCTGGCCCCCTGAAGACAT: CTGGCCCCCTGAAGACATA
CCTGGTTTGATGTCTTCTC: CTGGTTTGATGTCTTCTCC
CCTGTCGTACGTGCGTCGG: CTGTCGTACGTGCGTCGGA
CCTGTGCCAGCCGAGACCG: CTGTGCCAGCCGAGACCGA
CCTTAATGGGAAGTCTCTT: CTTAATGGGAAGTCTCTTA
CCTTAGAATACCACGCTTA: CTTAGAATACCACGCTTAT
CCTTTAGGTCCTGGCCCAG: CTTTAGGTCCTGGCCCAGT
CCTTTGTAGCCGCTCAGTT: CTTTGTAGCCGCTCAGTTC
CGAAACGGTAGTGTGCCCA: GAAACGGTAGTGTGCCCAT
CGAACACAGGCTTTCCGAC: GAACACAGGCTTTCCGACC
CGAACCAAACCCCACCGAT: GAACCAAACCCCACCGATT
CGAACCAGGAGCAGCTGAT: GAACCAGGAGCAGCTGATT
CGAACCGGTCGCCTACCAA: GAACCGGTCGCCTACCAAA
CGAACCGGTCGCCTACCCC: GAACCGGTCGCCTACCCCC
CGAACCGGTCGCCTACCCG: GAACCGGTCGCCTACCCGC
CGAACTACAGGTAGGAACA: GAACTACAGGTAGGAACAC
CGAACTGCACCTACGCCGG: GAACTGCACCTACGCCGGC
CGAACTTGCGAACCAGGAG: GAACTTGCGAACCAGGAGC
CGAAGCCTACGATAGCGTT: GAAGCCTACGATAGCGTTC
CGAATACAGGTACCGTTCC: GAATACAGGTACCGTTCCA
CGAATAGTGAGTGTAAGTA: GAATAGTGAGTGTAAGTAT
CGAATATGAGAAATCGATG: GAATATGAGAAATCGATGC
CGAATTACAATAAGAGCCA: GAATTACAATAAGAGCCAT
CGACAAGTCCCTGCCAAAA: GACAAGTCCCTGCCAAAAA
CGACCACCAAGGATTTTGA: GACCACCAAGGATTTTGAA
CGACCACCAAGGCGGCCTC: GACCACCAAGGCGGCCTCG
CGACCACCAAGGGAGATAA: GACCACCAAGGGAGATAAA
CGACCACCAAGGTTATAGC: GACCACCAAGGTTATAGCT
CGACCCGTGCTCGGGATTA: GACCCGTGCTCGGGATTAG
CGACCTAGTTTTTGCTCTG: GACCTAGTTTTTGCTCTGA
CGACGAACCGGTCGCCTAC: GACGAACCGGTCGCCTACC
CGACGATCGAACCAAACCC: GACGATCGAACCAAACCCC
CGACGCGCTATTGCATCGT: GACGCGCTATTGCATCGTG
CGACGTATCCCCAAATCAT: GACGTATCCCCAAATCATT
CGACGTTCGAGTCTCTTCG: GACGTTCGAGTCTCTTCGT
CGACGTTCTAAAACTGCCA: GACGTTCTAAAACTGCCAT
CGACTGCGAAGCCTACGAT: GACTGCGAAGCCTACGATA
CGAGACACCAGACCCATAG: GAGACACCAGACCCATAGG
CGAGACCGAATTACAATAA: GAGACCGAATTACAATAAG
CGAGACCTAAGCCATGCGC: GAGACCTAAGCCATGCGCG
CGAGCGAACTTGCGAACCA: GAGCGAACTTGCGAACCAG
CGAGCGAGGTTGTATATAT: GAGCGAGGTTGTATATATT
CGAGGTTGTATATATTTAC: GAGGTTGTATATATTTACG
CGAGTAGACCTTAGAATAC: GAGTAGACCTTAGAATACC
CGAGTCTCTTCGTCTAAAC: GAGTCTCTTCGTCTAAACG
CGAGTGCCAGCCATGTGCG: GAGTGCCAGCCATGTGCGA
CGATAGCGTTCGGTGTACT: GATAGCGTTCGGTGTACTA
CGATCCGAGCGAACTTGCG: GATCCGAGCGAACTTGCGA
CGATCGAACCAAACCCCAC: GATCGAACCAAACCCCACC
CGATCTCCCCTCCGCATTG: GATCTCCCCTCCGCATTGG
CGATCTCGATGGGTTACAA: GATCTCGATGGGTTACAAT
CGATCTGTAGATGGATGGA: GATCTGTAGATGGATGGAG
CGATGCTCTGGGGCCACTT: GATGCTCTGGGGCCACTTC
CGATGGGTTACAATTGTTT: GATGGGTTACAATTGTTTA
CGATTCCTCAGGGAAGGAC: GATTCCTCAGGGAAGGACT
CGATTCGGCGACCCGTGCT: GATTCGGCGACCCGTGCTC
CGCAATTTTTTTGTATTAT: GCAATTTTTTTGTATTATT
CGCACCACCGACGCGCTAT: GCACCACCGACGCGCTATT
CGCAGCATAATGGAGATCC: GCAGCATAATGGAGATCCT
CGCAGGGGATGTTCGTATA: GCAGGGGATGTTCGTATAG
CGCATAACTCGACAAGTCC: GCATAACTCGACAAGTCCC
CGCATTGGCTCACTACATC: GCATTGGCTCACTACATCT
CGCCAGAACATTCTCATCT: GCCAGAACATTCTCATCTA
CGCCCGCTAAGAGAGAATA: GCCCGCTAAGAGAGAATAC
CGCCGCGTTTCACGGTACG: GCCGCGTTTCACGGTACGA
CGCCGGCTCCCAGAATAAA: GCCGGCTCCCAGAATAAAA
CGCCTACCAAACAACTCGC: GCCTACCAAACAACTCGCG
CGCCTACCCCCACGGGATC: GCCTACCCCCACGGGATCC
CGCCTACCCGCCCGCTAAG: GCCTACCCGCCCGCTAAGA
CGCCTGGTTTGATGTCTTC: GCCTGGTTTGATGTCTTCT
CGCGAATACAGGTACCGTT: GCGAATACAGGTACCGTTC
CGCGCCTGGTTTGATGTCT: GCGCCTGGTTTGATGTCTT
CGCGCGAATACAGGTACCG: GCGCGAATACAGGTACCGT
CGCGCTATTGCATCGTGCA: GCGCTATTGCATCGTGCAG
CGCGTAAGCAACGCAATTT: GCGTAAGCAACGCAATTTT
CGCGTATAAATCCTCCACT: GCGTATAAATCCTCCACTC
CGCGTTTCACGGTACGAAC: GCGTTTCACGGTACGAACT
CGCTAAGAGAGAATACTAT: GCTAAGAGAGAATACTATA
CGCTATTGCATCGTGCAGG: GCTATTGCATCGTGCAGGG
CGCTCAGTTCTACCGGCAG: GCTCAGTTCTACCGGCAGT
CGCTCATCCCGACCACCAA: GCTCATCCCGACCACCAAG
CGCTTATAGATCAAGCACA: GCTTATAGATCAAGCACAG
CGCTTCCGGCCAAATTTGG: GCTTCCGGCCAAATTTGGA
CGGAACATTTCTGGGAGAA: GGAACATTTCTGGGAGAAG
CGGAAGCTCACCAACTAAA: GGAAGCTCACCAACTAAAG
CGGACAGGATCGCAGCATA: GGACAGGATCGCAGCATAA
CGGAGCGTTGGTTGAGTTA: GGAGCGTTGGTTGAGTTAG
CGGAGGCATGTTCGGAACA: GGAGGCATGTTCGGAACAT
CGGAGTTTGAGCTTTTTGG: GGAGTTTGAGCTTTTTGGG
CGGCACATCTTATTACTAG: GGCACATCTTATTACTAGC
CGGCACGTAGCAACATTCG: GGCACGTAGCAACATTCGA
CGGCAGGTATCTACACTCA: GGCAGGTATCTACACTCAT
CGGCAGTGTTACGCCAGAA: GGCAGTGTTACGCCAGAAC
CGGCATGCACATAGTTGAG: GGCATGCACATAGTTGAGT
CGGCCAAATTTGGAAGCGC: GGCCAAATTTGGAAGCGCA
CGGCCGAGCGAGGTTGTAT: GGCCGAGCGAGGTTGTATA
CGGCCTCGGTTGACGAACC: GGCCTCGGTTGACGAACCG
CGGCCTTAATGGGAAGTCT: GGCCTTAATGGGAAGTCTC
CGGCGACCCGTGCTCGGGA: GGCGACCCGTGCTCGGGAT
CGGCTCCCAGAATAAAAGC: GGCTCCCAGAATAAAAGCC
CGGGACGTGCGGCCGAGCG: GGGACGTGCGGCCGAGCGA
CGGGATAGGGAGCGTCTAG: GGGATAGGGAGCGTCTAGC
CGGGATCCGCTTCCGGCCA: GGGATCCGCTTCCGGCCAA
CGGGATTAGTCAGTAGACC: GGGATTAGTCAGTAGACCT
CGGGCGATCTCCCCTCCGC: GGGCGATCTCCCCTCCGCA
CGGGCTACTTGCGAGTAGA: GGGCTACTTGCGAGTAGAC
CGGGCTGAGTCCACACGGC: GGGCTGAGTCCACACGGCA
CGGGGCCCTACGGCCTTAA: GGGGCCCTACGGCCTTAAT
CGGGGGGAAGATGGCAGCC: GGGGGGAAGATGGCAGCCG
CGGGTCTACGACGTTCTAA: GGGTCTACGACGTTCTAAA
CGGGTCTGCATCATCCCCT: GGGTCTGCATCATCCCCTC
CGGGTGTTTGCACTTTTCG: GGGTGTTTGCACTTTTCGG
CGGTACGAACTACAGGTAG: GGTACGAACTACAGGTAGG
CGGTAGTGTGCCCATCGTC: GGTAGTGTGCCCATCGTCA
CGGTCGCCTACCAAACAAC: GGTCGCCTACCAAACAACT
CGGTCGCCTACCCCCACGG: GGTCGCCTACCCCCACGGG
CGGTCGCCTACCCGCCCGC: GGTCGCCTACCCGCCCGCT
CGGTGTACTAGGGTTAAAG: GGTGTACTAGGGTTAAAGG
CGGTTGACGAACCGGTCGC: GGTTGACGAACCGGTCGCC
CGTAACGATCCGAGCGAAC: GTAACGATCCGAGCGAACT
CGTAAGCAACGCAATTTTT: GTAAGCAACGCAATTTTTT
CGTACGTGCGTCGGAGGCA: GTACGTGCGTCGGAGGCAT
CGTAGCAACATTCGACGTA: GTAGCAACATTCGACGTAT
CGTATAAATCCTCCACTCT: GTATAAATCCTCCACTCTC
CGTATAGTCCAAGGTACAC: GTATAGTCCAAGGTACACG
CGTATCCCCAAATCATTCT: GTATCCCCAAATCATTCTT
CGTATGTGTTGTGCAGTTC: GTATGTGTTGTGCAGTTCG
CGTATTGCGTCTATAATGT: GTATTGCGTCTATAATGTG
CGTCATCCCGACCACCAAG: GTCATCCCGACCACCAAGG
CGTCGGAGGCATGTTCGGA: GTCGGAGGCATGTTCGGAA
CGTCGTTCTTCCTGCAGAA: GTCGTTCTTCCTGCAGAAT
CGTCTAAACGCATAACTCG: GTCTAAACGCATAACTCGA
CGTCTAGCACTGCGACGTT: GTCTAGCACTGCGACGTTC
CGTCTATAATGTGGCTAAA: GTCTATAATGTGGCTAAAA
CGTCTCGAACTGCACCTAC: GTCTCGAACTGCACCTACG
CGTGAAATTACCAGTGCTA: GTGAAATTACCAGTGCTAG
CGTGCAGGGCCCACGGGGG: GTGCAGGGCCCACGGGGGG
CGTGCGGCCGAGCGAGGTT: GTGCGGCCGAGCGAGGTTG
CGTGCGTCGGAGGCATGTT: GTGCGTCGGAGGCATGTTC
CGTGCTCGGGATTAGTCAG: GTGCTCGGGATTAGTCAGT
CGTGTTCTTCAACATCTAA: GTGTTCTTCAACATCTAAC
CGTTAACGCTCATCCCGAC: GTTAACGCTCATCCCGACC
CGTTATTTATGTTCAAAAA: GTTATTTATGTTCAAAAAG
CGTTCCAATGAATAAGAAT: GTTCCAATGAATAAGAATC
CGTTCGAGTCTCTTCGTCT: GTTCGAGTCTCTTCGTCTA
CGTTCGGTGTACTAGGGTT: GTTCGGTGTACTAGGGTTA
CGTTCTAAAACTGCCATAA: GTTCTAAAACTGCCATAAA
CGTTCTACCTGTCGTACGT: GTTCTACCTGTCGTACGTG
CGTTCTTCCTGCAGAATGG: GTTCTTCCTGCAGAATGGT
CGTTGGTTGAGTTAGTAAG: GTTGGTTGAGTTAGTAAGG
CGTTTCACGGTACGAACTA: GTTTCACGGTACGAACTAC
CGTTTTTGGGATCATCCCG: GTTTTTGGGATCATCCCGA
CTAAAACTGCCATAAAGCG: TAAAACTGCCATAAAGCGA
CTAAAAGATCGGGTGTTTG: TAAAAGATCGGGTGTTTGC
CTAAACGCATAACTCGACA: TAAACGCATAACTCGACAA
CTAAAGCCATGCACGGGAC: TAAAGCCATGCACGGGACG
CTAAAGCGGAGCGTTGGTT: TAAAGCGGAGCGTTGGTTG
CTAACCCCGCGCCTGGTTT: TAACCCCGCGCCTGGTTTG
CTAAGAGAGAATACTATAG: TAAGAGAGAATACTATAGG
CTAAGCCATGCGCGCGAAT: TAAGCCATGCGCGCGAATA
CTAATGTACAGGGCCTGAC: TAATGTACAGGGCCTGACC
CTACACTCATTGCAGACCA: TACACTCATTGCAGACCAA
CTACAGGTAGGAACACGTC: TACAGGTAGGAACACGTCG
CTACATCTCGGCACGTAGC: TACATCTCGGCACGTAGCA
CTACCAAACAACTCGCGTA: TACCAAACAACTCGCGTAT
CTACCCCCACGGGATCCGC: TACCCCCACGGGATCCGCT
CTACCCGCCCGCTAAGAGA: TACCCGCCCGCTAAGAGAG
CTACCGGCAGTGTTACGCC: TACCGGCAGTGTTACGCCA
CTACCTGGACGTAACGATC: TACCTGGACGTAACGATCC
CTACCTGTCGTACGTGCGT: TACCTGTCGTACGTGCGTC
CTACGACGTTCTAAAACTG: TACGACGTTCTAAAACTGC
CTACGAGTGCCAGCCATGT: TACGAGTGCCAGCCATGTG
CTACGATAGCGTTCGGTGT: TACGATAGCGTTCGGTGTA
CTACGCCGGCTCCCAGAAT: TACGCCGGCTCCCAGAATA
CTACGGCCTTAATGGGAAG: TACGGCCTTAATGGGAAGT
CTACTCCATCCGACGATCG: TACTCCATCCGACGATCGA
CTACTCCCCACAACTCGTA: TACTCCCCACAACTCGTAT
CTACTTGCGAGTAGACCTT: TACTTGCGAGTAGACCTTA
CTAGCACTGCGACGTTCGA: TAGCACTGCGACGTTCGAG
CTAGCCCACCCAGACCTAA: TAGCCCACCCAGACCTAAA
CTAGCGATCTCGATGGGTT: TAGCGATCTCGATGGGTTA
CTAGGGTTAAAGGGCAAGC: TAGGGTTAAAGGGCAAGCT
CTAGTTTTTGCTCTGAACA: TAGTTTTTGCTCTGAACAT
CTATAAGGGCCACAAATAG: TATAAGGGCCACAAATAGA
CTATAATGTGGCTAAAAGA: TATAATGTGGCTAAAAGAT
CTATACACCAAAAGCCACG: TATACACCAAAAGCCACGC
CTATAGGGTGTCACTTGTT: TATAGGGTGTCACTTGTTC
CTATCCCTAATGTACAGGG: TATCCCTAATGTACAGGGC
CTATTCATTTCTGCTACCT: TATTCATTTCTGCTACCTG
CTATTGCATCGTGCAGGGC: TATTGCATCGTGCAGGGCC
CTATTGTAGCTACTCCATC: TATTGTAGCTACTCCATCC
CTCACCAACTAAAGCCATG: TCACCAACTAAAGCCATGC
CTCACTACATCTCGGCACG: TCACTACATCTCGGCACGT
CTCACTGATCTGCCGAAAC: TCACTGATCTGCCGAAACG
CTCAGGGAAGGACTACGAG: TCAGGGAAGGACTACGAGT
CTCAGTTCTACCGGCAGTG: TCAGTTCTACCGGCAGTGT
CTCATCCCGACCACCAAGG: TCATCCCGACCACCAAGGC
CTCATCTATTGTAGCTACT: TCATCTATTGTAGCTACTC
CTCATTGCAGACCAAATAC: TCATTGCAGACCAAATACC
CTCCACTCTCTGATCAATC: TCCACTCTCTGATCAATCT
CTCCATCCGACGATCGAAC: TCCATCCGACGATCGAACC
CTCCCAGAATAAAAGCCAT: TCCCAGAATAAAAGCCATT
CTCCCCACAACTCGTATGT: TCCCCACAACTCGTATGTG
CTCCCCCGGCATGCACATA: TCCCCCGGCATGCACATAG
CTCCCCTCCGCATTGGCTC: TCCCCTCCGCATTGGCTCA
CTCCGCATTGGCTCACTAC: TCCGCATTGGCTCACTACA
CTCGAACTGCACCTACGCC: TCGAACTGCACCTACGCCG
CTCGACAAGTCCCTGCCAA: TCGACAAGTCCCTGCCAAA
CTCGATGGGTTACAATTGT: TCGATGGGTTACAATTGTT
CTCGCGTATAAATCCTCCA: TCGCGTATAAATCCTCCAC
CTCGGCACGTAGCAACATT: TCGGCACGTAGCAACATTC
CTCGGGATTAGTCAGTAGA: TCGGGATTAGTCAGTAGAC
CTCGGTTGACGAACCGGTC: TCGGTTGACGAACCGGTCG
CTCGTATGTGTTGTGCAGT: TCGTATGTGTTGTGCAGTT
CTCTCTGATCAATCTATAC: TCTCTGATCAATCTATACA
CTCTGAACATGTACTACTC: TCTGAACATGTACTACTCC
CTCTGATCAATCTATACAC: TCTGATCAATCTATACACC
CTCTGGACGAACCGGTCGC: TCTGGACGAACCGGTCGCC
CTCTGGGGCCACTTCCTTT: TCTGGGGCCACTTCCTTTA
CTCTTACTGCACTGTTCGC: TCTTACTGCACTGTTCGCA
CTCTTCATTGGTGCTATCC: TCTTCATTGGTGCTATCCC
CTCTTCGTCTAAACGCATA: TCTTCGTCTAAACGCATAA
CTGAACATGTACTACTCCC: TGAACATGTACTACTCCCC
CTGAAGACATAATATCGTC: TGAAGACATAATATCGTCT
CTGACCATGGGGAGGGGAA: TGACCATGGGGAGGGGAAC
CTGAGTCCACACGGCACAT: TGAGTCCACACGGCACATC
CTGATCAATCTATACACCA: TGATCAATCTATACACCAA
CTGATCTGCCGAAACGGTA: TGATCTGCCGAAACGGTAG
CTGATTTGAGACGAACACA: TGATTTGAGACGAACACAG
CTGCACCTACGCCGGCTCC: TGCACCTACGCCGGCTCCC
CTGCACTGTTCGCACCACC: TGCACTGTTCGCACCACCG
CTGCAGAATGGTGCGTTCT: TGCAGAATGGTGCGTTCTA
CTGCATCATCCCCTCACTG: TGCATCATCCCCTCACTGA
CTGCCAAAAAGCACCGTTT: TGCCAAAAAGCACCGTTTT
CTGCCATAAAGCGATTCGG: TGCCATAAAGCGATTCGGC
CTGCCGAAACGGTAGTGTG: TGCCGAAACGGTAGTGTGC
CTGCGAAGCCTACGATAGC: TGCGAAGCCTACGATAGCG
CTGCGACGTTCGAGTCTCT: TGCGACGTTCGAGTCTCTT
CTGCTACCTGGACGTAACG: TGCTACCTGGACGTAACGA
CTGGAAACTATAAGGGCCA: TGGAAACTATAAGGGCCAC
CTGGACGAACCGGTCGCCT: TGGACGAACCGGTCGCCTA
CTGGACGTAACGATCCGAG: TGGACGTAACGATCCGAGC
CTGGCCCAGTTCAATCCTT: TGGCCCAGTTCAATCCTTT
CTGGCCCCCTGAAGACATA: TGGCCCCCTGAAGACATAA
CTGGCGAATATGAGAAATC: TGGCGAATATGAGAAATCG
CTGGGAGAAGTGGATCTGG: TGGGAGAAGTGGATCTGGC
CTGGGGCCACTTCCTTTAG: TGGGGCCACTTCCTTTAGG
CTGGGTCGGGCTGAGTCCA: TGGGTCGGGCTGAGTCCAC
CTGGTTTGATGTCTTCTCC: TGGTTTGATGTCTTCTCCC
CTGTAAGATCCAGAGTACT: TGTAAGATCCAGAGTACTG
CTGTAGATGGATGGAGCCG: TGTAGATGGATGGAGCCGG
CTGTCCGGGCTACTTGCGA: TGTCCGGGCTACTTGCGAG
CTGTCGTACGTGCGTCGGA: TGTCGTACGTGCGTCGGAG
CTGTGCCAGCCGAGACCGA: TGTGCCAGCCGAGACCGAA
CTGTTCGCACCACCGACGC: TGTTCGCACCACCGACGCG
CTGTTTCGTGAAATTACCA: TGTTTCGTGAAATTACCAG
CTTAATGGGAAGTCTCTTA: TTAATGGGAAGTCTCTTAC
CTTACTGCACTGTTCGCAC: TTACTGCACTGTTCGCACC
CTTAGAATACCACGCTTAT: TTAGAATACCACGCTTATA
CTTATAGATCAAGCACAGT: TTATAGATCAAGCACAGTA
CTTATTACTAGCCCACCCA: TTATTACTAGCCCACCCAG
CTTCAACATCTAACCCCGC: TTCAACATCTAACCCCGCG
CTTCATTGGTGCTATCCCT: TTCATTGGTGCTATCCCTA
CTTCCGGCCAAATTTGGAA: TTCCGGCCAAATTTGGAAG
CTTCCTGCAGAATGGTGCG: TTCCTGCAGAATGGTGCGT
CTTCCTTTAGGTCCTGGCC: TTCCTTTAGGTCCTGGCCC
CTTCGTCTAAACGCATAAC: TTCGTCTAAACGCATAACT
CTTCTCCCCCGGCATGCAC: TTCTCCCCCGGCATGCACA
CTTGCGAACCAGGAGCAGC: TTGCGAACCAGGAGCAGCT
CTTGCGAGTAGACCTTAGA: TTGCGAGTAGACCTTAGAA
CTTGGCCATTCCCGAATAG: TTGGCCATTCCCGAATAGT
CTTGTTCCGATCTGTAGAT: TTGTTCCGATCTGTAGATG
CTTTAGGTCCTGGCCCAGT: TTTAGGTCCTGGCCCAGTT
CTTTCCGACCTAGTTTTTG: TTTCCGACCTAGTTTTTGC
CTTTGTAGCCGCTCAGTTC: TTTGTAGCCGCTCAGTTCT
CTTTTCGGGTCTACGACGT: TTTTCGGGTCTACGACGTT
CTTTTGAAGGATGCCGGGA: TTTTGAAGGATGCCGGGAT
CTTTTTGGGGAATTGATTG: TTTTTGGGGAATTGATTGC
GAAACGGTAGTGTGCCCAT: AAACGGTAGTGTGCCCATC
GAAACTATAAGGGCCACAA: AAACTATAAGGGCCACAAA
GAAATCGATGCTCTGGGGC: AAATCGATGCTCTGGGGCC
GAAATTACCAGTGCTAGCG: AAATTACCAGTGCTAGCGA
GAACACAGGCTTTCCGACC: AACACAGGCTTTCCGACCT
GAACACGTCGTTCTTCCTG: AACACGTCGTTCTTCCTGC
GAACATGTACTACTCCCCA: AACATGTACTACTCCCCAC
GAACATTCTCATCTATTGT: AACATTCTCATCTATTGTA
GAACATTTCTGGGAGAAGT: AACATTTCTGGGAGAAGTG
GAACCAAACCCCACCGATT: AACCAAACCCCACCGATTC
GAACCAGGAGCAGCTGATT: AACCAGGAGCAGCTGATTT
GAACCCGACGAACCGGTCG: AACCCGACGAACCGGTCGC
GAACCGGTCGCCTACCAAA: AACCGGTCGCCTACCAAAC
GAACCGGTCGCCTACCCCC: AACCGGTCGCCTACCCCCA
GAACCGGTCGCCTACCCGC: AACCGGTCGCCTACCCGCC
GAACCGTTAACGCTCATCC: AACCGTTAACGCTCATCCC
GAACGGGCGATCTCCCCTC: AACGGGCGATCTCCCCTCC
GAACTACAGGTAGGAACAC: AACTACAGGTAGGAACACG
GAACTGCACCTACGCCGGC: AACTGCACCTACGCCGGCT
GAACTTGCGAACCAGGAGC: AACTTGCGAACCAGGAGCA
GAAGACATAATATCGTCTC: AAGACATAATATCGTCTCG
GAAGATGGCAGCCGGACAG: AAGATGGCAGCCGGACAGG
GAAGCCTACGATAGCGTTC: AAGCCTACGATAGCGTTCG
GAAGCGCAGGGGATGTTCG: AAGCGCAGGGGATGTTCGT
GAAGCTCACCAACTAAAGC: AAGCTCACCAACTAAAGCC
GAAGGACTACGAGTGCCAG: AAGGACTACGAGTGCCAGC
GAAGGATGCCGGGATAGGG: AAGGATGCCGGGATAGGGA
GAAGTCTCTTACTGCACTG: AAGTCTCTTACTGCACTGT
GAAGTGGATCTGGCGAATA: AAGTGGATCTGGCGAATAT
GAATAAAAGCCATTGGGTA: AATAAAAGCCATTGGGTAC
GAATAAGAATCAATACAAG: AATAAGAATCAATACAAGG
GAATACAGGTACCGTTCCA: AATACAGGTACCGTTCCAA
GAATACCACGCTTATAGAT: AATACCACGCTTATAGATC
GAATACTATAGGGTGTCAC: AATACTATAGGGTGTCACT
GAATAGTGAGTGTAAGTAT: AATAGTGAGTGTAAGTATG
GAATATGAGAAATCGATGC: AATATGAGAAATCGATGCT
GAATCAATACAAGGTGTAG: AATCAATACAAGGTGTAGC
GAATGGTGCGTTCTACCTG: AATGGTGCGTTCTACCTGT
GAATTACAATAAGAGCCAT: AATTACAATAAGAGCCATT
GAATTGATTGCAACTGGGT: AATTGATTGCAACTGGGTC
GACAAGTCCCTGCCAAAAA: ACAAGTCCCTGCCAAAAAG
GACACCAGACCCATAGGTG: ACACCAGACCCATAGGTGG
GACAGGATCGCAGCATAAT: ACAGGATCGCAGCATAATG
GACATAATATCGTCTCGAA: ACATAATATCGTCTCGAAC
GACATAGGATTCCATAAAC: ACATAGGATTCCATAAACT
GACCAAATACCAAAAACTG: ACCAAATACCAAAAACTGT
GACCACCAAGGATTTTGAA: ACCACCAAGGATTTTGAAC
GACCACCAAGGCGGCCTCG: ACCACCAAGGCGGCCTCGG
GACCACCAAGGGAGATAAA: ACCACCAAGGGAGATAAAC
GACCACCAAGGTTATAGCT: ACCACCAAGGTTATAGCTC
GACCATGGGGAGGGGAACC: ACCATGGGGAGGGGAACCG
GACCCATAGGTGGAACGGG: ACCCATAGGTGGAACGGGC
GACCCGTGCTCGGGATTAG: ACCCGTGCTCGGGATTAGT
GACCGAATTACAATAAGAG: ACCGAATTACAATAAGAGC
GACCTAAAGCGGAGCGTTG: ACCTAAAGCGGAGCGTTGG
GACCTAAGCCATGCGCGCG: ACCTAAGCCATGCGCGCGA
GACCTAGTTTTTGCTCTGA: ACCTAGTTTTTGCTCTGAA
GACCTGTGCCAGCCGAGAC: ACCTGTGCCAGCCGAGACC
GACCTTAGAATACCACGCT: ACCTTAGAATACCACGCTT
GACGAACACAGGCTTTCCG: ACGAACACAGGCTTTCCGA
GACGAACCGGTCGCCTACC: ACGAACCGGTCGCCTACCC ACGAACCGGTCGCCTACCC ACGAACCGGTCGCCTACCT ACGAACCGGTCGCCTACCA
GACGAGACCTAAGCCATGC: ACGAGACCTAAGCCATGCG
GACGATCGAACCAAACCCC: ACGATCGAACCAAACCCCA
GACGCGCTATTGCATCGTG: ACGCGCTATTGCATCGTGC
GACGTAACGATCCGAGCGA: ACGTAACGATCCGAGCGAA
GACGTATCCCCAAATCATT: ACGTATCCCCAAATCATTC
GACGTGCGGCCGAGCGAGG: ACGTGCGGCCGAGCGAGGT
GACGTTCGAGTCTCTTCGT: ACGTTCGAGTCTCTTCGTC
GACGTTCTAAAACTGCCAT: ACGTTCTAAAACTGCCATA
GACTACGAGTGCCAGCCAT: ACTACGAGTGCCAGCCATG
GACTGCGAAGCCTACGATA: ACTGCGAAGCCTACGATAG
GAGAAATCGATGCTCTGGG: AGAAATCGATGCTCTGGGG
GAGAAGTGGATCTGGCGAA: AGAAGTGGATCTGGCGAAT
GAGAATACTATAGGGTGTC: AGAATACTATAGGGTGTCA
GAGACACCAGACCCATAGG: AGACACCAGACCCATAGGT
GAGACCGAATTACAATAAG: AGACCGAATTACAATAAGA
GAGACCTAAGCCATGCGCG: AGACCTAAGCCATGCGCGC
GAGACGAACACAGGCTTTC: AGACGAACACAGGCTTTCC
GAGAGAATACTATAGGGTG: AGAGAATACTATAGGGTGT
GAGATAAACAGGACGAACC: AGATAAACAGGACGAACCG
GAGATCCTGGCCCCCTGAA: AGATCCTGGCCCCCTGAAG
GAGCAGCTGATTTGAGACG: AGCAGCTGATTTGAGACGA
GAGCCATTGTCTTGGCCAT: AGCCATTGTCTTGGCCATT
GAGCCGGAGTTTGAGCTTT: AGCCGGAGTTTGAGCTTTT
GAGCGAACTTGCGAACCAG: AGCGAACTTGCGAACCAGG
GAGCGAGGTTGTATATATT: AGCGAGGTTGTATATATTT
GAGCGTCTAGCACTGCGAC: AGCGTCTAGCACTGCGACG
GAGCGTTGGTTGAGTTAGT: AGCGTTGGTTGAGTTAGTA
GAGCTTTTTGGGGAATTGA: AGCTTTTTGGGGAATTGAT
GAGGATACCTATTCATTTC: AGGATACCTATTCATTTCT
GAGGCATGTTCGGAACATT: AGGCATGTTCGGAACATTT
GAGGGGAACCGTTAACGCT: AGGGGAACCGTTAACGCTC
GAGGTTGTATATATTTACG: AGGTTGTATATATTTACGG
GAGTACTGTTTCGTGAAAT: AGTACTGTTTCGTGAAATT
GAGTAGACCTTAGAATACC: AGTAGACCTTAGAATACCA
GAGTCCACACGGCACATCT: AGTCCACACGGCACATCTT
GAGTCGGGTCTGCATCATC: AGTCGGGTCTGCATCATCC
GAGTCTCTTCGTCTAAACG: AGTCTCTTCGTCTAAACGC
GAGTGCCAGCCATGTGCGA: AGTGCCAGCCATGTGCGAG
GAGTGTAAGTATGGAGGAT: AGTGTAAGTATGGAGGATA
GAGTTAGTAAGGTCAGATC: AGTTAGTAAGGTCAGATCA
GAGTTTGAGCTTTTTGGGG: AGTTTGAGCTTTTTGGGGA
GATAAACAGGACGAACCGG: ATAAACAGGACGAACCGGT
GATACCTATTCATTTCTGC: ATACCTATTCATTTCTGCT
GATAGCGTTCGGTGTACTA: ATAGCGTTCGGTGTACTAG
GATAGGGAGCGTCTAGCAC: ATAGGGAGCGTCTAGCACT
GATCAAGCACAGTACACGT: ATCAAGCACAGTACACGTG
GATCAATCTATACACCAAA: ATCAATCTATACACCAAAA
GATCAGCGTATTGCGTCTA: ATCAGCGTATTGCGTCTAT
GATCATCCCGACCACCAAG: ATCATCCCGACCACCAAGG
GATCCAGAGTACTGTTTCG: ATCCAGAGTACTGTTTCGT
GATCCGAGCGAACTTGCGA: ATCCGAGCGAACTTGCGAA
GATCCGCTTCCGGCCAAAT: ATCCGCTTCCGGCCAAATT
GATCCTGGCCCCCTGAAGA: ATCCTGGCCCCCTGAAGAC
GATCGAACCAAACCCCACC: ATCGAACCAAACCCCACCG
GATCGCAGCATAATGGAGA: ATCGCAGCATAATGGAGAT
GATCGGGTGTTTGCACTTT: ATCGGGTGTTTGCACTTTT
GATCTCCCCTCCGCATTGG: ATCTCCCCTCCGCATTGGC
GATCTCGATGGGTTACAAT: ATCTCGATGGGTTACAATT
GATCTGCCGAAACGGTAGT: ATCTGCCGAAACGGTAGTG
GATCTGGCGAATATGAGAA: ATCTGGCGAATATGAGAAA
GATCTGTAGATGGATGGAG: ATCTGTAGATGGATGGAGC
GATGCCGGGATAGGGAGCG: ATGCCGGGATAGGGAGCGT
GATGCTCTGGGGCCACTTC: ATGCTCTGGGGCCACTTCC
GATGGAGCCGGAGTTTGAG: ATGGAGCCGGAGTTTGAGC
GATGGATGGAGCCGGAGTT: ATGGATGGAGCCGGAGTTT
GATGGCAGCCGGACAGGAT: ATGGCAGCCGGACAGGATC
GATGGGTTACAATTGTTTA: ATGGGTTACAATTGTTTAT
GATGTCTTCTCCCCCGGCA: ATGTCTTCTCCCCCGGCAT
GATGTTCGTATAGTCCAAG: ATGTTCGTATAGTCCAAGG
GATTAGTCAGTAGACCTGT: ATTAGTCAGTAGACCTGTG
GATTCCATAAACTCTTCAT: ATTCCATAAACTCTTCATT
GATTCCTCAGGGAAGGACT: ATTCCTCAGGGAAGGACTA
GATTCGGCGACCCGTGCTC: ATTCGGCGACCCGTGCTCG
GATTGCAACTGGGTCGGGC: ATTGCAACTGGGTCGGGCT
GATTTGAGACGAACACAGG: ATTTGAGACGAACACAGGC
GATTTTGAACCCGACGAAC: ATTTTGAACCCGACGAACC
GCAACATTCGACGTATCCC: CAACATTCGACGTATCCCC
GCAACGCAATTTTTTTGTA: CAACGCAATTTTTTTGTAT
GCAACTGGGTCGGGCTGAG: CAACTGGGTCGGGCTGAGT
GCAAGCTGGAAACTATAAG: CAAGCTGGAAACTATAAGG
GCAATTTTTTTGTATTATT: CAATTTTTTTGTATTATTG
GCACAGTACACGTGTTCTT: CACAGTACACGTGTTCTTC
GCACATAGTTGAGTCGGGT: CACATAGTTGAGTCGGGTC
GCACATCTTATTACTAGCC: CACATCTTATTACTAGCCC
GCACCACCGACGCGCTATT: CACCACCGACGCGCTATTG
GCACCGTTTTTGGGATCAT: CACCGTTTTTGGGATCATC
GCACCTACGCCGGCTCCCA: CACCTACGCCGGCTCCCAG
GCACGGGACGTGCGGCCGA: CACGGGACGTGCGGCCGAG
GCACGTAGCAACATTCGAC: CACGTAGCAACATTCGACG
GCACTGCGACGTTCGAGTC: CACTGCGACGTTCGAGTCT
GCACTGTTCGCACCACCGA: CACTGTTCGCACCACCGAC
GCACTTTTCGGGTCTACGA: CACTTTTCGGGTCTACGAC
GCAGAATGGTGCGTTCTAC: CAGAATGGTGCGTTCTACC
GCAGACCAAATACCAAAAA: CAGACCAAATACCAAAAAC
GCAGCATAATGGAGATCCT: CAGCATAATGGAGATCCTG
GCAGCCGGACAGGATCGCA: CAGCCGGACAGGATCGCAG
GCAGCTGATTTGAGACGAA: CAGCTGATTTGAGACGAAC
GCAGGGCCCACGGGGGGAA: CAGGGCCCACGGGGGGAAG
GCAGGGGATGTTCGTATAG: CAGGGGATGTTCGTATAGT
GCAGGTATCTACACTCATT: CAGGTATCTACACTCATTG
GCAGTGTTACGCCAGAACA: CAGTGTTACGCCAGAACAT
GCAGTTCGGCAGGTATCTA: CAGTTCGGCAGGTATCTAC
GCATAACTCGACAAGTCCC: CATAACTCGACAAGTCCCT
GCATAATGGAGATCCTGGC: CATAATGGAGATCCTGGCC
GCATCATCCCCTCACTGAT: CATCATCCCCTCACTGATC
GCATCGTGCAGGGCCCACG: CATCGTGCAGGGCCCACGG
GCATGCACATAGTTGAGTC: CATGCACATAGTTGAGTCG
GCATGTTCGGAACATTTCT: CATGTTCGGAACATTTCTG
GCATTGGCTCACTACATCT: CATTGGCTCACTACATCTC
GCCAAAAAGCACCGTTTTT: CCAAAAAGCACCGTTTTTG
GCCAAATTTGGAAGCGCAG: CCAAATTTGGAAGCGCAGG
GCCACAAATAGACGAGACC: CCACAAATAGACGAGACCT
GCCACGCGTAAGCAACGCA: CCACGCGTAAGCAACGCAA
GCCACTTCCTTTAGGTCCT: CCACTTCCTTTAGGTCCTG
GCCAGAACATTCTCATCTA: CCAGAACATTCTCATCTAT
GCCAGCCATGTGCGAGACA: CCAGCCATGTGCGAGACAC
GCCAGCCGAGACCGAATTA: CCAGCCGAGACCGAATTAC
GCCATAAAGCGATTCGGCG: CCATAAAGCGATTCGGCGA
GCCATGCACGGGACGTGCG: CCATGCACGGGACGTGCGG
GCCATGCGCGCGAATACAG: CCATGCGCGCGAATACAGG
GCCATGTGCGAGACACCAG: CCATGTGCGAGACACCAGA
GCCATTCCCGAATAGTGAG: CCATTCCCGAATAGTGAGT
GCCATTGGGTACATTAGGC: CCATTGGGTACATTAGGCT
GCCATTGTCTTGGCCATTC: CCATTGTCTTGGCCATTCC
GCCCACCCAGACCTAAAGC: CCCACCCAGACCTAAAGCG
GCCCACGGGGGGAAGATGG: CCCACGGGGGGAAGATGGC
GCCCAGTTCAATCCTTTGT: CCCAGTTCAATCCTTTGTA
GCCCATCGTCATCCCGACC: CCCATCGTCATCCCGACCA
GCCCCCTGAAGACATAATA: CCCCCTGAAGACATAATAT
GCCCGCTAAGAGAGAATAC: CCCGCTAAGAGAGAATACT
GCCCTACGGCCTTAATGGG: CCCTACGGCCTTAATGGGA
GCCGAAACGGTAGTGTGCC: CCGAAACGGTAGTGTGCCC
GCCGAGACCGAATTACAAT: CCGAGACCGAATTACAATA
GCCGAGCGAGGTTGTATAT: CCGAGCGAGGTTGTATATA
GCCGCGTTTCACGGTACGA: CCGCGTTTCACGGTACGAA
GCCGCTCAGTTCTACCGGC: CCGCTCAGTTCTACCGGCA
GCCGGACAGGATCGCAGCA: CCGGACAGGATCGCAGCAT
GCCGGAGTTTGAGCTTTTT: CCGGAGTTTGAGCTTTTTG
GCCGGCTCCCAGAATAAAA: CCGGCTCCCAGAATAAAAG
GCCGGGATAGGGAGCGTCT: CCGGGATAGGGAGCGTCTA
GCCTACCAAACAACTCGCG: CCTACCAAACAACTCGCGT
GCCTACCCCCACGGGATCC: CCTACCCCCACGGGATCCG
GCCTACCCGCCCGCTAAGA: CCTACCCGCCCGCTAAGAG
GCCTACGATAGCGTTCGGT: CCTACGATAGCGTTCGGTG
GCCTCGGTTGACGAACCGG: CCTCGGTTGACGAACCGGT
GCCTGACCATGGGGAGGGG: CCTGACCATGGGGAGGGGA
GCCTGGTTTGATGTCTTCT: CCTGGTTTGATGTCTTCTC
GCCTTAATGGGAAGTCTCT: CCTTAATGGGAAGTCTCTT
GCGAACCAGGAGCAGCTGA: CGAACCAGGAGCAGCTGAT
GCGAACTTGCGAACCAGGA: CGAACTTGCGAACCAGGAG
GCGAAGCCTACGATAGCGT: CGAAGCCTACGATAGCGTT
GCGAATACAGGTACCGTTC: CGAATACAGGTACCGTTCC
GCGAATATGAGAAATCGAT: CGAATATGAGAAATCGATG
GCGACCCGTGCTCGGGATT: CGACCCGTGCTCGGGATTA
GCGACGTTCGAGTCTCTTC: CGACGTTCGAGTCTCTTCG
GCGAGACACCAGACCCATA: CGAGACACCAGACCCATAG
GCGAGGTTGTATATATTTA: CGAGGTTGTATATATTTAC
GCGAGTAGACCTTAGAATA: CGAGTAGACCTTAGAATAC
GCGATCTCCCCTCCGCATT: CGATCTCCCCTCCGCATTG
GCGATCTCGATGGGTTACA: CGATCTCGATGGGTTACAA
GCGATTCGGCGACCCGTGC: CGATTCGGCGACCCGTGCT
GCGCAGGGGATGTTCGTAT: CGCAGGGGATGTTCGTATA
GCGCCGCGTTTCACGGTAC: CGCCGCGTTTCACGGTACG
GCGCCTGGTTTGATGTCTT: CGCCTGGTTTGATGTCTTC
GCGCGAATACAGGTACCGT: CGCGAATACAGGTACCGTT
GCGCGCGAATACAGGTACC: CGCGCGAATACAGGTACCG
GCGCTATTGCATCGTGCAG: CGCTATTGCATCGTGCAGG
GCGGAAGCTCACCAACTAA: CGGAAGCTCACCAACTAAA
GCGGAGCGTTGGTTGAGTT: CGGAGCGTTGGTTGAGTTA
GCGGCCGAGCGAGGTTGTA: CGGCCGAGCGAGGTTGTAT
GCGGCCTCGGTTGACGAAC: CGGCCTCGGTTGACGAACC
GCGTAAGCAACGCAATTTT: CGTAAGCAACGCAATTTTT
GCGTATAAATCCTCCACTC: CGTATAAATCCTCCACTCT
GCGTATTGCGTCTATAATG: CGTATTGCGTCTATAATGT
GCGTCGGAGGCATGTTCGG: CGTCGGAGGCATGTTCGGA
GCGTCTAGCACTGCGACGT: CGTCTAGCACTGCGACGTT
GCGTCTATAATGTGGCTAA: CGTCTATAATGTGGCTAAA
GCGTTATTTATGTTCAAAA: CGTTATTTATGTTCAAAAA
GCGTTCGGTGTACTAGGGT: CGTTCGGTGTACTAGGGTT
GCGTTCTACCTGTCGTACG: CGTTCTACCTGTCGTACGT
GCGTTGGTTGAGTTAGTAA: CGTTGGTTGAGTTAGTAAG
GCGTTTCACGGTACGAACT: CGTTTCACGGTACGAACTA
GCTAAAAGATCGGGTGTTT: CTAAAAGATCGGGTGTTTG
GCTAAGAGAGAATACTATA: CTAAGAGAGAATACTATAG
GCTACCTGGACGTAACGAT: CTACCTGGACGTAACGATC
GCTACTCCATCCGACGATC: CTACTCCATCCGACGATCG
GCTACTTGCGAGTAGACCT: CTACTTGCGAGTAGACCTT
GCTAGCGATCTCGATGGGT: CTAGCGATCTCGATGGGTT
GCTATCCCTAATGTACAGG: CTATCCCTAATGTACAGGG
GCTATTGCATCGTGCAGGG: CTATTGCATCGTGCAGGGC
GCTCACCAACTAAAGCCAT: CTCACCAACTAAAGCCATG
GCTCACTACATCTCGGCAC: CTCACTACATCTCGGCACG
GCTCAGTTCTACCGGCAGT: CTCAGTTCTACCGGCAGTG
GCTCATCCCGACCACCAAG: CTCATCCCGACCACCAAGG
GCTCCCAGAATAAAAGCCA: CTCCCAGAATAAAAGCCAT
GCTCGGGATTAGTCAGTAG: CTCGGGATTAGTCAGTAGA
GCTCTGAACATGTACTACT: CTCTGAACATGTACTACTC
GCTCTGGACGAACCGGTCG: CTCTGGACGAACCGGTCGC
GCTCTGGGGCCACTTCCTT: CTCTGGGGCCACTTCCTTT
GCTGAGTCCACACGGCACA: CTGAGTCCACACGGCACAT
GCTGATTTGAGACGAACAC: CTGATTTGAGACGAACACA
GCTGGAAACTATAAGGGCC: CTGGAAACTATAAGGGCCA
GCTGTAAGATCCAGAGTAC: CTGTAAGATCCAGAGTACT
GCTTATAGATCAAGCACAG: CTTATAGATCAAGCACAGT
GCTTCCGGCCAAATTTGGA: CTTCCGGCCAAATTTGGAA
GCTTTCCGACCTAGTTTTT: CTTTCCGACCTAGTTTTTG
GCTTTTTGGGGAATTGATT: CTTTTTGGGGAATTGATTG
GGAAACTATAAGGGCCACA: GAAACTATAAGGGCCACAA
GGAACACGTCGTTCTTCCT: GAACACGTCGTTCTTCCTG
GGAACATTTCTGGGAGAAG: GAACATTTCTGGGAGAAGT
GGAACCGTTAACGCTCATC: GAACCGTTAACGCTCATCC
GGAACGGGCGATCTCCCCT: GAACGGGCGATCTCCCCTC
GGAAGATGGCAGCCGGACA: GAAGATGGCAGCCGGACAG
GGAAGCGCAGGGGATGTTC: GAAGCGCAGGGGATGTTCG
GGAAGCTCACCAACTAAAG: GAAGCTCACCAACTAAAGC
GGAAGGACTACGAGTGCCA: GAAGGACTACGAGTGCCAG
GGAAGTCTCTTACTGCACT: GAAGTCTCTTACTGCACTG
GGAATTGATTGCAACTGGG: GAATTGATTGCAACTGGGT
GGACAGGATCGCAGCATAA: GACAGGATCGCAGCATAAT
GGACGAACCGGTCGCCTAC: GACGAACCGGTCGCCTACC GACGAACCGGTCGCCTACC
GGACGTAACGATCCGAGCG: GACGTAACGATCCGAGCGA
GGACGTGCGGCCGAGCGAG: GACGTGCGGCCGAGCGAGG
GGACTACGAGTGCCAGCCA: GACTACGAGTGCCAGCCAT
GGAGAAGTGGATCTGGCGA: GAGAAGTGGATCTGGCGAA
GGAGATAAACAGGACGAAC: GAGATAAACAGGACGAACC
GGAGATCCTGGCCCCCTGA: GAGATCCTGGCCCCCTGAA
GGAGCAGCTGATTTGAGAC: GAGCAGCTGATTTGAGACG
GGAGCCGGAGTTTGAGCTT: GAGCCGGAGTTTGAGCTTT
GGAGCGTCTAGCACTGCGA: GAGCGTCTAGCACTGCGAC
GGAGCGTTGGTTGAGTTAG: GAGCGTTGGTTGAGTTAGT
GGAGGATACCTATTCATTT: GAGGATACCTATTCATTTC
GGAGGCATGTTCGGAACAT: GAGGCATGTTCGGAACATT
GGAGGGGAACCGTTAACGC: GAGGGGAACCGTTAACGCT
GGAGTTTGAGCTTTTTGGG: GAGTTTGAGCTTTTTGGGG
GGATACCTATTCATTTCTG: GATACCTATTCATTTCTGC
GGATAGGGAGCGTCTAGCA: GATAGGGAGCGTCTAGCAC
GGATCATCCCGACCACCAA: GATCATCCCGACCACCAAG
GGATCCGCTTCCGGCCAAA: GATCCGCTTCCGGCCAAAT
GGATCGCAGCATAATGGAG: GATCGCAGCATAATGGAGA
GGATCTGGCGAATATGAGA: GATCTGGCGAATATGAGAA
GGATGCCGGGATAGGGAGC: GATGCCGGGATAGGGAGCG
GGATGGAGCCGGAGTTTGA: GATGGAGCCGGAGTTTGAG
GGATGTTCGTATAGTCCAA: GATGTTCGTATAGTCCAAG
GGATTAGTCAGTAGACCTG: GATTAGTCAGTAGACCTGT
GGATTCCATAAACTCTTCA: GATTCCATAAACTCTTCAT
GGATTTTGAACCCGACGAA: GATTTTGAACCCGACGAAC
GGCAAGCTGGAAACTATAA: GCAAGCTGGAAACTATAAG
GGCACATCTTATTACTAGC: GCACATCTTATTACTAGCC
GGCACGTAGCAACATTCGA: GCACGTAGCAACATTCGAC
GGCAGCCGGACAGGATCGC: GCAGCCGGACAGGATCGCA
GGCAGGTATCTACACTCAT: GCAGGTATCTACACTCATT
GGCAGTGTTACGCCAGAAC: GCAGTGTTACGCCAGAACA
GGCATGCACATAGTTGAGT: GCATGCACATAGTTGAGTC
GGCATGTTCGGAACATTTC: GCATGTTCGGAACATTTCT
GGCCAAATTTGGAAGCGCA: GCCAAATTTGGAAGCGCAG
GGCCACAAATAGACGAGAC: GCCACAAATAGACGAGACC
GGCCACTTCCTTTAGGTCC: GCCACTTCCTTTAGGTCCT
GGCCATTCCCGAATAGTGA: GCCATTCCCGAATAGTGAG
GGCCCACGGGGGGAAGATG: GCCCACGGGGGGAAGATGG
GGCCCAGTTCAATCCTTTG: GCCCAGTTCAATCCTTTGT
GGCCCCCTGAAGACATAAT: GCCCCCTGAAGACATAATA
GGCCCTACGGCCTTAATGG: GCCCTACGGCCTTAATGGG
GGCCGAGCGAGGTTGTATA: GCCGAGCGAGGTTGTATAT
GGCCTCGGTTGACGAACCG: GCCTCGGTTGACGAACCGG
GGCCTGACCATGGGGAGGG: GCCTGACCATGGGGAGGGG
GGCCTTAATGGGAAGTCTC: GCCTTAATGGGAAGTCTCT
GGCGAATATGAGAAATCGA: GCGAATATGAGAAATCGAT
GGCGACCCGTGCTCGGGAT: GCGACCCGTGCTCGGGATT
GGCGATCTCCCCTCCGCAT: GCGATCTCCCCTCCGCATT
GGCGGCCTCGGTTGACGAA: GCGGCCTCGGTTGACGAAC
GGCTAAAAGATCGGGTGTT: GCTAAAAGATCGGGTGTTT
GGCTACTTGCGAGTAGACC: GCTACTTGCGAGTAGACCT
GGCTCACTACATCTCGGCA: GCTCACTACATCTCGGCAC
GGCTCCCAGAATAAAAGCC: GCTCCCAGAATAAAAGCCA
GGCTGAGTCCACACGGCAC: GCTGAGTCCACACGGCACA
GGCTGTAAGATCCAGAGTA: GCTGTAAGATCCAGAGTAC
GGCTTTCCGACCTAGTTTT: GCTTTCCGACCTAGTTTTT
GGGAACCGTTAACGCTCAT: GGAACCGTTAACGCTCATC
GGGAAGATGGCAGCCGGAC: GGAAGATGGCAGCCGGACA
GGGAAGGACTACGAGTGCC: GGAAGGACTACGAGTGCCA
GGGAAGTCTCTTACTGCAC: GGAAGTCTCTTACTGCACT
GGGAATTGATTGCAACTGG: GGAATTGATTGCAACTGGG
GGGACGTGCGGCCGAGCGA: GGACGTGCGGCCGAGCGAG
GGGAGAAGTGGATCTGGCG: GGAGAAGTGGATCTGGCGA
GGGAGATAAACAGGACGAA: GGAGATAAACAGGACGAAC
GGGAGCGTCTAGCACTGCG: GGAGCGTCTAGCACTGCGA
GGGAGGGGAACCGTTAACG: GGAGGGGAACCGTTAACGC
GGGATAGGGAGCGTCTAGC: GGATAGGGAGCGTCTAGCA
GGGATCATCCCGACCACCA: GGATCATCCCGACCACCAA
GGGATCCGCTTCCGGCCAA: GGATCCGCTTCCGGCCAAA
GGGATGTTCGTATAGTCCA: GGATGTTCGTATAGTCCAA
GGGATTAGTCAGTAGACCT: GGATTAGTCAGTAGACCTG
GGGCAAGCTGGAAACTATA: GGCAAGCTGGAAACTATAA
GGGCCACAAATAGACGAGA: GGCCACAAATAGACGAGAC
GGGCCACTTCCTTTAGGTC: GGCCACTTCCTTTAGGTCC
GGGCCCACGGGGGGAAGAT: GGCCCACGGGGGGAAGATG
GGGCCCTACGGCCTTAATG: GGCCCTACGGCCTTAATGG
GGGCCTGACCATGGGGAGG: GGCCTGACCATGGGGAGGG
GGGCGATCTCCCCTCCGCA: GGCGATCTCCCCTCCGCAT
GGGCTACTTGCGAGTAGAC: GGCTACTTGCGAGTAGACC
GGGCTGAGTCCACACGGCA: GGCTGAGTCCACACGGCAC
GGGGAACCGTTAACGCTCA: GGGAACCGTTAACGCTCAT
GGGGAAGATGGCAGCCGGA: GGGAAGATGGCAGCCGGAC
GGGGAATTGATTGCAACTG: GGGAATTGATTGCAACTGG
GGGGAGGGGAACCGTTAAC: GGGAGGGGAACCGTTAACG
GGGGATGTTCGTATAGTCC: GGGATGTTCGTATAGTCCA
GGGGCCACTTCCTTTAGGT: GGGCCACTTCCTTTAGGTC
GGGGCCCTACGGCCTTAAT: GGGCCCTACGGCCTTAATG
GGGGGAAGATGGCAGCCGG: GGGGAAGATGGCAGCCGGA
GGGGGGAAGATGGCAGCCG: GGGGGAAGATGGCAGCCGG
GGGTACATTAGGCTGTAAG: GGTACATTAGGCTGTAAGA
GGGTCGGGCTGAGTCCACA: GGTCGGGCTGAGTCCACAC
GGGTCTACGACGTTCTAAA: GGTCTACGACGTTCTAAAA
GGGTCTGCATCATCCCCTC: GGTCTGCATCATCCCCTCA
GGGTGTCACTTGTTCCGAT: GGTGTCACTTGTTCCGATC
GGGTGTTTGCACTTTTCGG: GGTGTTTGCACTTTTCGGG
GGGTTAAAGGGCAAGCTGG: GGTTAAAGGGCAAGCTGGA
GGGTTACAATTGTTTATGT: GGTTACAATTGTTTATGTT
GGTACACGACTGCGAAGCC: GTACACGACTGCGAAGCCT
GGTACATTAGGCTGTAAGA: GTACATTAGGCTGTAAGAT
GGTACCGTTCCAATGAATA: GTACCGTTCCAATGAATAA
GGTACGAACTACAGGTAGG: GTACGAACTACAGGTAGGA
GGTAGGAACACGTCGTTCT: GTAGGAACACGTCGTTCTT
GGTAGTGTGCCCATCGTCA: GTAGTGTGCCCATCGTCAT
GGTATCTACACTCATTGCA: GTATCTACACTCATTGCAG
GGTCAGATCAGCGTATTGC: GTCAGATCAGCGTATTGCG
GGTCCTGGCCCAGTTCAAT: GTCCTGGCCCAGTTCAATC
GGTCGCCTACCAAACAACT: GTCGCCTACCAAACAACTC
GGTCGCCTACCCCCACGGG: GTCGCCTACCCCCACGGGA
GGTCGCCTACCCGCCCGCT: GTCGCCTACCCGCCCGCTA
GGTCGGGCTGAGTCCACAC: GTCGGGCTGAGTCCACACG
GGTCTACGACGTTCTAAAA: GTCTACGACGTTCTAAAAC
GGTCTGCATCATCCCCTCA: GTCTGCATCATCCCCTCAC
GGTGCGTTCTACCTGTCGT: GTGCGTTCTACCTGTCGTA
GGTGCTATCCCTAATGTAC: GTGCTATCCCTAATGTACA
GGTGGAACGGGCGATCTCC: GTGGAACGGGCGATCTCCC
GGTGTACTAGGGTTAAAGG: GTGTACTAGGGTTAAAGGG
GGTGTAGCGGAAGCTCACC: GTGTAGCGGAAGCTCACCA
GGTGTCACTTGTTCCGATC: GTGTCACTTGTTCCGATCT
GGTGTTTGCACTTTTCGGG: GTGTTTGCACTTTTCGGGT
GGTTAAAGGGCAAGCTGGA: GTTAAAGGGCAAGCTGGAA
GGTTACAATTGTTTATGTT: GTTACAATTGTTTATGTTG
GGTTATAGCTCTGGACGAA: GTTATAGCTCTGGACGAAC
GGTTGACGAACCGGTCGCC: GTTGACGAACCGGTCGCCT
GGTTGAGTTAGTAAGGTCA: GTTGAGTTAGTAAGGTCAG
GGTTGTATATATTTACGGG: GTTGTATATATTTACGGGG
GGTTTGATGTCTTCTCCCC: GTTTGATGTCTTCTCCCCC
GTAACGATCCGAGCGAACT: TAACGATCCGAGCGAACTT
GTAAGATCCAGAGTACTGT: TAAGATCCAGAGTACTGTT
GTAAGCAACGCAATTTTTT: TAAGCAACGCAATTTTTTT
GTAAGGTCAGATCAGCGTA: TAAGGTCAGATCAGCGTAT
GTAAGTATGGAGGATACCT: TAAGTATGGAGGATACCTA
GTACACGACTGCGAAGCCT: TACACGACTGCGAAGCCTA
GTACACGTGTTCTTCAACA: TACACGTGTTCTTCAACAT
GTACAGGGCCTGACCATGG: TACAGGGCCTGACCATGGG
GTACATTAGGCTGTAAGAT: TACATTAGGCTGTAAGATC
GTACCGTTCCAATGAATAA: TACCGTTCCAATGAATAAG
GTACGAACTACAGGTAGGA: TACGAACTACAGGTAGGAA
GTACGTGCGTCGGAGGCAT: TACGTGCGTCGGAGGCATG
GTACTACTCCCCACAACTC: TACTACTCCCCACAACTCG
GTACTAGGGTTAAAGGGCA: TACTAGGGTTAAAGGGCAA
GTACTGTTTCGTGAAATTA: TACTGTTTCGTGAAATTAC
GTAGACCTGTGCCAGCCGA: TAGACCTGTGCCAGCCGAG
GTAGACCTTAGAATACCAC: TAGACCTTAGAATACCACG
GTAGATGGATGGAGCCGGA: TAGATGGATGGAGCCGGAG
GTAGCAACATTCGACGTAT: TAGCAACATTCGACGTATC
GTAGCCGCTCAGTTCTACC: TAGCCGCTCAGTTCTACCG
GTAGCGGAAGCTCACCAAC: TAGCGGAAGCTCACCAACT
GTAGCTACTCCATCCGACG: TAGCTACTCCATCCGACGA
GTAGGAACACGTCGTTCTT: TAGGAACACGTCGTTCTTC
GTAGTGTGCCCATCGTCAT: TAGTGTGCCCATCGTCATC
GTATAAATCCTCCACTCTC: TATAAATCCTCCACTCTCT
GTATAGTCCAAGGTACACG: TATAGTCCAAGGTACACGA
GTATATATTTACGGGGCCC: TATATATTTACGGGGCCCT
GTATCCCCAAATCATTCTT: TATCCCCAAATCATTCTTT
GTATCTACACTCATTGCAG: TATCTACACTCATTGCAGA
GTATGGAGGATACCTATTC: TATGGAGGATACCTATTCA
GTATGTGTTGTGCAGTTCG: TATGTGTTGTGCAGTTCGG
GTATTATTGCGTTATTTAT: TATTATTGCGTTATTTATG
GTATTGCGTCTATAATGTG: TATTGCGTCTATAATGTGG
GTCACTTGTTCCGATCTGT: TCACTTGTTCCGATCTGTA
GTCAGATCAGCGTATTGCG: TCAGATCAGCGTATTGCGT
GTCAGTAGACCTGTGCCAG: TCAGTAGACCTGTGCCAGC
GTCATCCCGACCACCAAGG: TCATCCCGACCACCAAGGG
GTCCAAGGTACACGACTGC: TCCAAGGTACACGACTGCG
GTCCACACGGCACATCTTA: TCCACACGGCACATCTTAT
GTCCCTGCCAAAAAGCACC: TCCCTGCCAAAAAGCACCG
GTCCGGGCTACTTGCGAGT: TCCGGGCTACTTGCGAGTA
GTCCTGGCCCAGTTCAATC: TCCTGGCCCAGTTCAATCC
GTCGCCTACCAAACAACTC: TCGCCTACCAAACAACTCG
GTCGCCTACCCCCACGGGA: TCGCCTACCCCCACGGGAT
GTCGCCTACCCGCCCGCTA: TCGCCTACCCGCCCGCTAA
GTCGGAGGCATGTTCGGAA: TCGGAGGCATGTTCGGAAC
GTCGGGCTGAGTCCACACG: TCGGGCTGAGTCCACACGG
GTCGGGTCTGCATCATCCC: TCGGGTCTGCATCATCCCC
GTCGTACGTGCGTCGGAGG: TCGTACGTGCGTCGGAGGC
GTCGTTCTTCCTGCAGAAT: TCGTTCTTCCTGCAGAATG
GTCTAAACGCATAACTCGA: TCTAAACGCATAACTCGAC
GTCTACGACGTTCTAAAAC: TCTACGACGTTCTAAAACT
GTCTAGCACTGCGACGTTC: TCTAGCACTGCGACGTTCG
GTCTATAATGTGGCTAAAA: TCTATAATGTGGCTAAAAG
GTCTCGAACTGCACCTACG: TCTCGAACTGCACCTACGC
GTCTCTTACTGCACTGTTC: TCTCTTACTGCACTGTTCG
GTCTCTTCGTCTAAACGCA: TCTCTTCGTCTAAACGCAT
GTCTGCATCATCCCCTCAC: TCTGCATCATCCCCTCACT
GTCTTCTCCCCCGGCATGC: TCTTCTCCCCCGGCATGCA
GTCTTGGCCATTCCCGAAT: TCTTGGCCATTCCCGAATA
GTGAAATTACCAGTGCTAG: TGAAATTACCAGTGCTAGC
GTGAGTGTAAGTATGGAGG: TGAGTGTAAGTATGGAGGA
GTGCAGGGCCCACGGGGGG: TGCAGGGCCCACGGGGGGA
GTGCAGTTCGGCAGGTATC: TGCAGTTCGGCAGGTATCT
GTGCCAGCCATGTGCGAGA: TGCCAGCCATGTGCGAGAC
GTGCCAGCCGAGACCGAAT: TGCCAGCCGAGACCGAATT
GTGCCCATCGTCATCCCGA: TGCCCATCGTCATCCCGAC
GTGCGAGACACCAGACCCA: TGCGAGACACCAGACCCAT
GTGCGGCCGAGCGAGGTTG: TGCGGCCGAGCGAGGTTGT
GTGCGTCGGAGGCATGTTC: TGCGTCGGAGGCATGTTCG
GTGCGTTCTACCTGTCGTA: TGCGTTCTACCTGTCGTAC
GTGCTAGCGATCTCGATGG: TGCTAGCGATCTCGATGGG
GTGCTATCCCTAATGTACA: TGCTATCCCTAATGTACAG
GTGCTCGGGATTAGTCAGT: TGCTCGGGATTAGTCAGTA
GTGGAACGGGCGATCTCCC: TGGAACGGGCGATCTCCCC
GTGGATCTGGCGAATATGA: TGGATCTGGCGAATATGAG
GTGGCTAAAAGATCGGGTG: TGGCTAAAAGATCGGGTGT
GTGTAAGTATGGAGGATAC: TGTAAGTATGGAGGATACC
GTGTACTAGGGTTAAAGGG: TGTACTAGGGTTAAAGGGC
GTGTAGCGGAAGCTCACCA: TGTAGCGGAAGCTCACCAA
GTGTCACTTGTTCCGATCT: TGTCACTTGTTCCGATCTG
GTGTGCCCATCGTCATCCC: TGTGCCCATCGTCATCCCG
GTGTTACGCCAGAACATTC: TGTTACGCCAGAACATTCT
GTGTTCTTCAACATCTAAC: TGTTCTTCAACATCTAACC
GTGTTGTGCAGTTCGGCAG: TGTTGTGCAGTTCGGCAGG
GTGTTTGCACTTTTCGGGT: TGTTTGCACTTTTCGGGTC
GTTAAAGGGCAAGCTGGAA: TTAAAGGGCAAGCTGGAAA
GTTAACGCTCATCCCGACC: TTAACGCTCATCCCGACCA
GTTACAATTGTTTATGTTG: TTACAATTGTTTATGTTGC
GTTACGCCAGAACATTCTC: TTACGCCAGAACATTCTCA
GTTAGTAAGGTCAGATCAG: TTAGTAAGGTCAGATCAGC
GTTATAGCTCTGGACGAAC: TTATAGCTCTGGACGAACC
GTTATTTATGTTCAAAAAG: TTATTTATGTTCAAAAAGA
GTTCAAAAAGACATAGGAT: TTCAAAAAGACATAGGATT
GTTCAATCCTTTGTAGCCG: TTCAATCCTTTGTAGCCGC
GTTCATCCCGACCACCAAG: TTCATCCCGACCACCAAGG
GTTCCAATGAATAAGAATC: TTCCAATGAATAAGAATCA
GTTCCGATCTGTAGATGGA: TTCCGATCTGTAGATGGAT
GTTCGAGTCTCTTCGTCTA: TTCGAGTCTCTTCGTCTAA
GTTCGCACCACCGACGCGC: TTCGCACCACCGACGCGCT
GTTCGGAACATTTCTGGGA: TTCGGAACATTTCTGGGAG
GTTCGGCAGGTATCTACAC: TTCGGCAGGTATCTACACT
GTTCGGTGTACTAGGGTTA: TTCGGTGTACTAGGGTTAA
GTTCGTATAGTCCAAGGTA: TTCGTATAGTCCAAGGTAC
GTTCTAAAACTGCCATAAA: TTCTAAAACTGCCATAAAG
GTTCTACCGGCAGTGTTAC: TTCTACCGGCAGTGTTACG
GTTCTACCTGTCGTACGTG: TTCTACCTGTCGTACGTGC
GTTCTTCAACATCTAACCC: TTCTTCAACATCTAACCCC
GTTCTTCCTGCAGAATGGT: TTCTTCCTGCAGAATGGTG
GTTGACGAACCGGTCGCCT: TTGACGAACCGGTCGCCTA
GTTGAGTCGGGTCTGCATC: TTGAGTCGGGTCTGCATCA
GTTGAGTTAGTAAGGTCAG: TTGAGTTAGTAAGGTCAGA
GTTGCGCCGCGTTTCACGG: TTGCGCCGCGTTTCACGGT
GTTGGTTGAGTTAGTAAGG: TTGGTTGAGTTAGTAAGGT
GTTGTATATATTTACGGGG: TTGTATATATTTACGGGGC
GTTGTGCAGTTCGGCAGGT: TTGTGCAGTTCGGCAGGTA
GTTTATGTTGCGCCGCGTT: TTTATGTTGCGCCGCGTTT
GTTTCACGGTACGAACTAC: TTTCACGGTACGAACTACA
GTTTCGTGAAATTACCAGT: TTTCGTGAAATTACCAGTG
GTTTGAGCTTTTTGGGGAA: TTTGAGCTTTTTGGGGAAT
GTTTGATGTCTTCTCCCCC: TTTGATGTCTTCTCCCCCG
GTTTGCACTTTTCGGGTCT: TTTGCACTTTTCGGGTCTA
GTTTTTGCTCTGAACATGT: TTTTTGCTCTGAACATGTA
GTTTTTGGGATCATCCCGA: TTTTTGGGATCATCCCGAC
TAAAACTGCCATAAAGCGA: AAAACTGCCATAAAGCGAT
TAAAAGATCGGGTGTTTGC: AAAAGATCGGGTGTTTGCA
TAAAAGCCATTGGGTACAT: AAAAGCCATTGGGTACATT
TAAACAGGACGAACCGGTC: AAACAGGACGAACCGGTCG
TAAACGCATAACTCGACAA: AAACGCATAACTCGACAAG
TAAACTCTTCATTGGTGCT: AAACTCTTCATTGGTGCTA
TAAAGCCATGCACGGGACG: AAAGCCATGCACGGGACGT
TAAAGCGATTCGGCGACCC: AAAGCGATTCGGCGACCCG
TAAAGCGGAGCGTTGGTTG: AAAGCGGAGCGTTGGTTGA
TAAAGGGCAAGCTGGAAAC: AAAGGGCAAGCTGGAAACT
TAAATCCTCCACTCTCTGA: AAATCCTCCACTCTCTGAT
TAACCCCGCGCCTGGTTTG: AACCCCGCGCCTGGTTTGA
TAACGATCCGAGCGAACTT: AACGATCCGAGCGAACTTG
TAACGCTCATCCCGACCAC: AACGCTCATCCCGACCACC
TAACTCGACAAGTCCCTGC: AACTCGACAAGTCCCTGCC
TAAGAATCAATACAAGGTG: AAGAATCAATACAAGGTGT
TAAGAGAGAATACTATAGG: AAGAGAGAATACTATAGGG
TAAGAGCCATTGTCTTGGC: AAGAGCCATTGTCTTGGCC
TAAGATCCAGAGTACTGTT: AAGATCCAGAGTACTGTTT
TAAGCAACGCAATTTTTTT: AAGCAACGCAATTTTTTTG
TAAGCCATGCGCGCGAATA: AAGCCATGCGCGCGAATAC
TAAGGGCCACAAATAGACG: AAGGGCCACAAATAGACGA
TAAGGTCAGATCAGCGTAT: AAGGTCAGATCAGCGTATT
TAAGTATGGAGGATACCTA: AAGTATGGAGGATACCTAT
TAATATCGTCTCGAACTGC: AATATCGTCTCGAACTGCA
TAATGGAGATCCTGGCCCC: AATGGAGATCCTGGCCCCC
TAATGGGAAGTCTCTTACT: AATGGGAAGTCTCTTACTG
TAATGTACAGGGCCTGACC: AATGTACAGGGCCTGACCA
TAATGTGGCTAAAAGATCG: AATGTGGCTAAAAGATCGG
TACAAGGTGTAGCGGAAGC: ACAAGGTGTAGCGGAAGCT
TACAATAAGAGCCATTGTC: ACAATAAGAGCCATTGTCT
TACAATTGTTTATGTTGCG: ACAATTGTTTATGTTGCGC
TACACCAAAAGCCACGCGT: ACACCAAAAGCCACGCGTA
TACACGACTGCGAAGCCTA: ACACGACTGCGAAGCCTAC
TACACGTGTTCTTCAACAT: ACACGTGTTCTTCAACATC
TACACTCATTGCAGACCAA: ACACTCATTGCAGACCAAA
TACAGGGCCTGACCATGGG: ACAGGGCCTGACCATGGGG
TACAGGTACCGTTCCAATG: ACAGGTACCGTTCCAATGA
TACAGGTAGGAACACGTCG: ACAGGTAGGAACACGTCGT
TACATCTCGGCACGTAGCA: ACATCTCGGCACGTAGCAA
TACATTAGGCTGTAAGATC: ACATTAGGCTGTAAGATCC
TACCAAAAACTGTCCGGGC: ACCAAAAACTGTCCGGGCT
TACCAAACAACTCGCGTAT: ACCAAACAACTCGCGTATA
TACCACGCTTATAGATCAA: ACCACGCTTATAGATCAAG
TACCAGTGCTAGCGATCTC: ACCAGTGCTAGCGATCTCG
TACCCCCACGGGATCCGCT: ACCCCCACGGGATCCGCTT
TACCCGCCCGCTAAGAGAG: ACCCGCCCGCTAAGAGAGA
TACCGGCAGTGTTACGCCA: ACCGGCAGTGTTACGCCAG
TACCGTTCCAATGAATAAG: ACCGTTCCAATGAATAAGA
TACCTATTCATTTCTGCTA: ACCTATTCATTTCTGCTAC
TACCTGGACGTAACGATCC: ACCTGGACGTAACGATCCG
TACCTGTCGTACGTGCGTC: ACCTGTCGTACGTGCGTCG
TACGAACTACAGGTAGGAA: ACGAACTACAGGTAGGAAC
TACGACGTTCTAAAACTGC: ACGACGTTCTAAAACTGCC
TACGAGTGCCAGCCATGTG: ACGAGTGCCAGCCATGTGC
TACGATAGCGTTCGGTGTA: ACGATAGCGTTCGGTGTAC
TACGCCAGAACATTCTCAT: ACGCCAGAACATTCTCATC
TACGCCGGCTCCCAGAATA: ACGCCGGCTCCCAGAATAA
TACGGCCTTAATGGGAAGT: ACGGCCTTAATGGGAAGTC
TACGGGGCCCTACGGCCTT: ACGGGGCCCTACGGCCTTA
TACGTGCGTCGGAGGCATG: ACGTGCGTCGGAGGCATGT
TACTACTCCCCACAACTCG: ACTACTCCCCACAACTCGT
TACTAGCCCACCCAGACCT: ACTAGCCCACCCAGACCTA
TACTAGGGTTAAAGGGCAA: ACTAGGGTTAAAGGGCAAG
TACTATAGGGTGTCACTTG: ACTATAGGGTGTCACTTGT
TACTCCATCCGACGATCGA: ACTCCATCCGACGATCGAA
TACTCCCCACAACTCGTAT: ACTCCCCACAACTCGTATG
TACTGCACTGTTCGCACCA: ACTGCACTGTTCGCACCAC
TACTGTTTCGTGAAATTAC: ACTGTTTCGTGAAATTACC
TACTTGCGAGTAGACCTTA: ACTTGCGAGTAGACCTTAG
TAGAATACCACGCTTATAG: AGAATACCACGCTTATAGA
TAGACCTGTGCCAGCCGAG: AGACCTGTGCCAGCCGAGA
TAGACCTTAGAATACCACG: AGACCTTAGAATACCACGC
TAGACGAGACCTAAGCCAT: AGACGAGACCTAAGCCATG
TAGATCAAGCACAGTACAC: AGATCAAGCACAGTACACG
TAGATGGATGGAGCCGGAG: AGATGGATGGAGCCGGAGT
TAGCAACATTCGACGTATC: AGCAACATTCGACGTATCC
TAGCACTGCGACGTTCGAG: AGCACTGCGACGTTCGAGT
TAGCCCACCCAGACCTAAA: AGCCCACCCAGACCTAAAG
TAGCCGCTCAGTTCTACCG: AGCCGCTCAGTTCTACCGG
TAGCGATCTCGATGGGTTA: AGCGATCTCGATGGGTTAC
TAGCGGAAGCTCACCAACT: AGCGGAAGCTCACCAACTA
TAGCGTTCGGTGTACTAGG: AGCGTTCGGTGTACTAGGG
TAGCTACTCCATCCGACGA: AGCTACTCCATCCGACGAT
TAGCTCTGGACGAACCGGT: AGCTCTGGACGAACCGGTC
TAGGAACACGTCGTTCTTC: AGGAACACGTCGTTCTTCC
TAGGATTCCATAAACTCTT: AGGATTCCATAAACTCTTC
TAGGCTGTAAGATCCAGAG: AGGCTGTAAGATCCAGAGT
TAGGGAGCGTCTAGCACTG: AGGGAGCGTCTAGCACTGC
TAGGGTGTCACTTGTTCCG: AGGGTGTCACTTGTTCCGA
TAGGGTTAAAGGGCAAGCT: AGGGTTAAAGGGCAAGCTG
TAGGTCCTGGCCCAGTTCA: AGGTCCTGGCCCAGTTCAA
TAGGTGGAACGGGCGATCT: AGGTGGAACGGGCGATCTC
TAGTAAGGTCAGATCAGCG: AGTAAGGTCAGATCAGCGT
TAGTCAGTAGACCTGTGCC: AGTCAGTAGACCTGTGCCA
TAGTCCAAGGTACACGACT: AGTCCAAGGTACACGACTG
TAGTGAGTGTAAGTATGGA: AGTGAGTGTAAGTATGGAG
TAGTGTGCCCATCGTCATC: AGTGTGCCCATCGTCATCC
TAGTTCATCCCGACCACCA: AGTTCATCCCGACCACCAA
TAGTTGAGTCGGGTCTGCA: AGTTGAGTCGGGTCTGCAT
TAGTTTTTGCTCTGAACAT: AGTTTTTGCTCTGAACATG
TATAAATCCTCCACTCTCT: ATAAATCCTCCACTCTCTG
TATAAGGGCCACAAATAGA: ATAAGGGCCACAAATAGAC
TATAATGTGGCTAAAAGAT: ATAATGTGGCTAAAAGATC
TATACACCAAAAGCCACGC: ATACACCAAAAGCCACGCG
TATAGATCAAGCACAGTAC: ATAGATCAAGCACAGTACA
TATAGCTCTGGACGAACCG: ATAGCTCTGGACGAACCGG
TATAGGGTGTCACTTGTTC: ATAGGGTGTCACTTGTTCC
TATAGTCCAAGGTACACGA: ATAGTCCAAGGTACACGAC
TATATATTTACGGGGCCCT: ATATATTTACGGGGCCCTA
TATATTTACGGGGCCCTAC: ATATTTACGGGGCCCTACG
TATCCCCAAATCATTCTTT: ATCCCCAAATCATTCTTTT
TATCCCTAATGTACAGGGC: ATCCCTAATGTACAGGGCC
TATCGTCTCGAACTGCACC: ATCGTCTCGAACTGCACCT
TATCTACACTCATTGCAGA: ATCTACACTCATTGCAGAC
TATGAGAAATCGATGCTCT: ATGAGAAATCGATGCTCTG
TATGGAGGATACCTATTCA: ATGGAGGATACCTATTCAT
TATGTGTTGTGCAGTTCGG: ATGTGTTGTGCAGTTCGGC
TATGTTCAAAAAGACATAG: ATGTTCAAAAAGACATAGG
TATGTTGCGCCGCGTTTCA: ATGTTGCGCCGCGTTTCAC
TATTACTAGCCCACCCAGA: ATTACTAGCCCACCCAGAC
TATTATTGCGTTATTTATG: ATTATTGCGTTATTTATGT
TATTCATTTCTGCTACCTG: ATTCATTTCTGCTACCTGG
TATTGCATCGTGCAGGGCC: ATTGCATCGTGCAGGGCCC
TATTGCGTCTATAATGTGG: ATTGCGTCTATAATGTGGC
TATTGCGTTATTTATGTTC: ATTGCGTTATTTATGTTCA
TATTGTAGCTACTCCATCC: ATTGTAGCTACTCCATCCG
TATTTACGGGGCCCTACGG: ATTTACGGGGCCCTACGGC
TATTTATGTTCAAAAAGAC: ATTTATGTTCAAAAAGACA
TCAAAAAGACATAGGATTC: CAAAAAGACATAGGATTCC
TCAACATCTAACCCCGCGC: CAACATCTAACCCCGCGCC
TCAAGCACAGTACACGTGT: CAAGCACAGTACACGTGTT
TCAATACAAGGTGTAGCGG: CAATACAAGGTGTAGCGGA
TCAATCCTTTGTAGCCGCT: CAATCCTTTGTAGCCGCTC
TCAATCTATACACCAAAAG: CAATCTATACACCAAAAGC
TCACCAACTAAAGCCATGC: CACCAACTAAAGCCATGCA
TCACGGTACGAACTACAGG: CACGGTACGAACTACAGGT
TCACTACATCTCGGCACGT: CACTACATCTCGGCACGTA
TCACTGATCTGCCGAAACG: CACTGATCTGCCGAAACGG
TCACTTGTTCCGATCTGTA: CACTTGTTCCGATCTGTAG
TCAGATCAGCGTATTGCGT: CAGATCAGCGTATTGCGTC
TCAGCGTATTGCGTCTATA: CAGCGTATTGCGTCTATAA
TCAGGGAAGGACTACGAGT: CAGGGAAGGACTACGAGTG
TCAGTAGACCTGTGCCAGC: CAGTAGACCTGTGCCAGCC
TCAGTTCTACCGGCAGTGT: CAGTTCTACCGGCAGTGTT
TCATCCCCTCACTGATCTG: CATCCCCTCACTGATCTGC
TCATCCCGACCACCAAGGA: CATCCCGACCACCAAGGAT
TCATCCCGACCACCAAGGC: CATCCCGACCACCAAGGCG
TCATCCCGACCACCAAGGG: CATCCCGACCACCAAGGGA
TCATCCCGACCACCAAGGT: CATCCCGACCACCAAGGTT
TCATCTATTGTAGCTACTC: CATCTATTGTAGCTACTCC
TCATTCTTTTGAAGGATGC: CATTCTTTTGAAGGATGCC
TCATTGCAGACCAAATACC: CATTGCAGACCAAATACCA
TCATTGGTGCTATCCCTAA: CATTGGTGCTATCCCTAAT
TCATTTCTGCTACCTGGAC: CATTTCTGCTACCTGGACG
TCCAAGGTACACGACTGCG: CCAAGGTACACGACTGCGA
TCCAATGAATAAGAATCAA: CCAATGAATAAGAATCAAT
TCCACACGGCACATCTTAT: CCACACGGCACATCTTATT
TCCACTCTCTGATCAATCT: CCACTCTCTGATCAATCTA
TCCAGAGTACTGTTTCGTG: CCAGAGTACTGTTTCGTGA
TCCATAAACTCTTCATTGG: CCATAAACTCTTCATTGGT
TCCATCCGACGATCGAACC: CCATCCGACGATCGAACCA
TCCCAGAATAAAAGCCATT: CCCAGAATAAAAGCCATTG
TCCCCAAATCATTCTTTTG: CCCCAAATCATTCTTTTGA
TCCCCACAACTCGTATGTG: CCCCACAACTCGTATGTGT
TCCCCCGGCATGCACATAG: CCCCCGGCATGCACATAGT
TCCCCTCACTGATCTGCCG: CCCCTCACTGATCTGCCGA
TCCCCTCCGCATTGGCTCA: CCCCTCCGCATTGGCTCAC
TCCCGAATAGTGAGTGTAA: CCCGAATAGTGAGTGTAAG
TCCCGACCACCAAGGATTT: CCCGACCACCAAGGATTTT
TCCCGACCACCAAGGCGGC: CCCGACCACCAAGGCGGCC
TCCCGACCACCAAGGGAGA: CCCGACCACCAAGGGAGAT
TCCCGACCACCAAGGTTAT: CCCGACCACCAAGGTTATA
TCCCTAATGTACAGGGCCT: CCCTAATGTACAGGGCCTG
TCCCTGCCAAAAAGCACCG: CCCTGCCAAAAAGCACCGT
TCCGACCTAGTTTTTGCTC: CCGACCTAGTTTTTGCTCT
TCCGACGATCGAACCAAAC: CCGACGATCGAACCAAACC
TCCGAGCGAACTTGCGAAC: CCGAGCGAACTTGCGAACC
TCCGATCTGTAGATGGATG: CCGATCTGTAGATGGATGG
TCCGCATTGGCTCACTACA: CCGCATTGGCTCACTACAT
TCCGCTTCCGGCCAAATTT: CCGCTTCCGGCCAAATTTG
TCCGGCCAAATTTGGAAGC: CCGGCCAAATTTGGAAGCG
TCCGGGCTACTTGCGAGTA: CCGGGCTACTTGCGAGTAG
TCCTCAGGGAAGGACTACG: CCTCAGGGAAGGACTACGA
TCCTCCACTCTCTGATCAA: CCTCCACTCTCTGATCAAT
TCCTGCAGAATGGTGCGTT: CCTGCAGAATGGTGCGTTC
TCCTGGCCCAGTTCAATCC: CCTGGCCCAGTTCAATCCT
TCCTGGCCCCCTGAAGACA: CCTGGCCCCCTGAAGACAT
TCCTTTAGGTCCTGGCCCA: CCTTTAGGTCCTGGCCCAG
TCCTTTGTAGCCGCTCAGT: CCTTTGTAGCCGCTCAGTT
TCGAACCAAACCCCACCGA: CGAACCAAACCCCACCGAT
TCGAACTGCACCTACGCCG: CGAACTGCACCTACGCCGG
TCGACAAGTCCCTGCCAAA: CGACAAGTCCCTGCCAAAA
TCGACGTATCCCCAAATCA: CGACGTATCCCCAAATCAT
TCGAGTCTCTTCGTCTAAA: CGAGTCTCTTCGTCTAAAC
TCGATGCTCTGGGGCCACT: CGATGCTCTGGGGCCACTT
TCGATGGGTTACAATTGTT: CGATGGGTTACAATTGTTT
TCGCACCACCGACGCGCTA: CGCACCACCGACGCGCTAT
TCGCAGCATAATGGAGATC: CGCAGCATAATGGAGATCC
TCGCCTACCAAACAACTCG: CGCCTACCAAACAACTCGC
TCGCCTACCCCCACGGGAT: CGCCTACCCCCACGGGATC
TCGCCTACCCGCCCGCTAA: CGCCTACCCGCCCGCTAAG
TCGCGTATAAATCCTCCAC: CGCGTATAAATCCTCCACT
TCGGAACATTTCTGGGAGA: CGGAACATTTCTGGGAGAA
TCGGAGGCATGTTCGGAAC: CGGAGGCATGTTCGGAACA
TCGGCACGTAGCAACATTC: CGGCACGTAGCAACATTCG
TCGGCAGGTATCTACACTC: CGGCAGGTATCTACACTCA
TCGGCGACCCGTGCTCGGG: CGGCGACCCGTGCTCGGGA
TCGGGATTAGTCAGTAGAC: CGGGATTAGTCAGTAGACC
TCGGGCTGAGTCCACACGG: CGGGCTGAGTCCACACGGC
TCGGGTCTACGACGTTCTA: CGGGTCTACGACGTTCTAA
TCGGGTCTGCATCATCCCC: CGGGTCTGCATCATCCCCT
TCGGGTGTTTGCACTTTTC: CGGGTGTTTGCACTTTTCG
TCGGTGTACTAGGGTTAAA: CGGTGTACTAGGGTTAAAG
TCGGTTGACGAACCGGTCG: CGGTTGACGAACCGGTCGC
TCGTACGTGCGTCGGAGGC: CGTACGTGCGTCGGAGGCA
TCGTATAGTCCAAGGTACA: CGTATAGTCCAAGGTACAC
TCGTATGTGTTGTGCAGTT: CGTATGTGTTGTGCAGTTC
TCGTCATCCCGACCACCAA: CGTCATCCCGACCACCAAG
TCGTCTAAACGCATAACTC: CGTCTAAACGCATAACTCG
TCGTCTCGAACTGCACCTA: CGTCTCGAACTGCACCTAC
TCGTGAAATTACCAGTGCT: CGTGAAATTACCAGTGCTA
TCGTGCAGGGCCCACGGGG: CGTGCAGGGCCCACGGGGG
TCGTTCTTCCTGCAGAATG: CGTTCTTCCTGCAGAATGG
TCTAAAACTGCCATAAAGC: CTAAAACTGCCATAAAGCG
TCTAAACGCATAACTCGAC: CTAAACGCATAACTCGACA
TCTAACCCCGCGCCTGGTT: CTAACCCCGCGCCTGGTTT
TCTACACTCATTGCAGACC: CTACACTCATTGCAGACCA
TCTACCGGCAGTGTTACGC: CTACCGGCAGTGTTACGCC
TCTACCTGTCGTACGTGCG: CTACCTGTCGTACGTGCGT
TCTACGACGTTCTAAAACT: CTACGACGTTCTAAAACTG
TCTAGCACTGCGACGTTCG: CTAGCACTGCGACGTTCGA
TCTATAATGTGGCTAAAAG: CTATAATGTGGCTAAAAGA
TCTATACACCAAAAGCCAC: CTATACACCAAAAGCCACG
TCTATTGTAGCTACTCCAT: CTATTGTAGCTACTCCATC
TCTCATCTATTGTAGCTAC: CTCATCTATTGTAGCTACT
TCTCCCCCGGCATGCACAT: CTCCCCCGGCATGCACATA
TCTCCCCTCCGCATTGGCT: CTCCCCTCCGCATTGGCTC
TCTCGAACTGCACCTACGC: CTCGAACTGCACCTACGCC
TCTCGATGGGTTACAATTG: CTCGATGGGTTACAATTGT
TCTCGGCACGTAGCAACAT: CTCGGCACGTAGCAACATT
TCTCTGATCAATCTATACA: CTCTGATCAATCTATACAC
TCTCTTACTGCACTGTTCG: CTCTTACTGCACTGTTCGC
TCTCTTCGTCTAAACGCAT: CTCTTCGTCTAAACGCATA
TCTGAACATGTACTACTCC: CTGAACATGTACTACTCCC
TCTGATCAATCTATACACC: CTGATCAATCTATACACCA
TCTGCATCATCCCCTCACT: CTGCATCATCCCCTCACTG
TCTGCCGAAACGGTAGTGT: CTGCCGAAACGGTAGTGTG
TCTGCTACCTGGACGTAAC: CTGCTACCTGGACGTAACG
TCTGGACGAACCGGTCGCC: CTGGACGAACCGGTCGCCT
TCTGGCGAATATGAGAAAT: CTGGCGAATATGAGAAATC
TCTGGGAGAAGTGGATCTG: CTGGGAGAAGTGGATCTGG
TCTGGGGCCACTTCCTTTA: CTGGGGCCACTTCCTTTAG
TCTGTAGATGGATGGAGCC: CTGTAGATGGATGGAGCCG
TCTTACTGCACTGTTCGCA: CTTACTGCACTGTTCGCAC
TCTTATTACTAGCCCACCC: CTTATTACTAGCCCACCCA
TCTTCAACATCTAACCCCG: CTTCAACATCTAACCCCGC
TCTTCATTGGTGCTATCCC: CTTCATTGGTGCTATCCCT
TCTTCCTGCAGAATGGTGC: CTTCCTGCAGAATGGTGCG
TCTTCGTCTAAACGCATAA: CTTCGTCTAAACGCATAAC
TCTTCTCCCCCGGCATGCA: CTTCTCCCCCGGCATGCAC
TCTTGGCCATTCCCGAATA: CTTGGCCATTCCCGAATAG
TCTTTTGAAGGATGCCGGG: CTTTTGAAGGATGCCGGGA
TGAAATTACCAGTGCTAGC: GAAATTACCAGTGCTAGCG
TGAACATGTACTACTCCCC: GAACATGTACTACTCCCCA
TGAACCCGACGAACCGGTC: GAACCCGACGAACCGGTCG
TGAAGACATAATATCGTCT: GAAGACATAATATCGTCTC
TGAAGGATGCCGGGATAGG: GAAGGATGCCGGGATAGGG
TGAATAAGAATCAATACAA: GAATAAGAATCAATACAAG
TGACCATGGGGAGGGGAAC: GACCATGGGGAGGGGAACC
TGACGAACCGGTCGCCTAC: GACGAACCGGTCGCCTACC
TGAGAAATCGATGCTCTGG: GAGAAATCGATGCTCTGGG
TGAGACGAACACAGGCTTT: GAGACGAACACAGGCTTTC
TGAGCTTTTTGGGGAATTG: GAGCTTTTTGGGGAATTGA
TGAGTCCACACGGCACATC: GAGTCCACACGGCACATCT
TGAGTCGGGTCTGCATCAT: GAGTCGGGTCTGCATCATC
TGAGTGTAAGTATGGAGGA: GAGTGTAAGTATGGAGGAT
TGAGTTAGTAAGGTCAGAT: GAGTTAGTAAGGTCAGATC
TGATCAATCTATACACCAA: GATCAATCTATACACCAAA
TGATCTGCCGAAACGGTAG: GATCTGCCGAAACGGTAGT
TGATGTCTTCTCCCCCGGC: GATGTCTTCTCCCCCGGCA
TGATTGCAACTGGGTCGGG: GATTGCAACTGGGTCGGGC
TGATTTGAGACGAACACAG: GATTTGAGACGAACACAGG
TGCAACTGGGTCGGGCTGA: GCAACTGGGTCGGGCTGAG
TGCACATAGTTGAGTCGGG: GCACATAGTTGAGTCGGGT
TGCACCTACGCCGGCTCCC: GCACCTACGCCGGCTCCCA
TGCACGGGACGTGCGGCCG: GCACGGGACGTGCGGCCGA
TGCACTGTTCGCACCACCG: GCACTGTTCGCACCACCGA
TGCACTTTTCGGGTCTACG: GCACTTTTCGGGTCTACGA
TGCAGAATGGTGCGTTCTA: GCAGAATGGTGCGTTCTAC
TGCAGACCAAATACCAAAA: GCAGACCAAATACCAAAAA
TGCAGGGCCCACGGGGGGA: GCAGGGCCCACGGGGGGAA
TGCAGTTCGGCAGGTATCT: GCAGTTCGGCAGGTATCTA
TGCATCATCCCCTCACTGA: GCATCATCCCCTCACTGAT
TGCATCGTGCAGGGCCCAC: GCATCGTGCAGGGCCCACG
TGCCAAAAAGCACCGTTTT: GCCAAAAAGCACCGTTTTT
TGCCAGCCATGTGCGAGAC: GCCAGCCATGTGCGAGACA
TGCCAGCCGAGACCGAATT: GCCAGCCGAGACCGAATTA
TGCCATAAAGCGATTCGGC: GCCATAAAGCGATTCGGCG
TGCCCATCGTCATCCCGAC: GCCCATCGTCATCCCGACC
TGCCGAAACGGTAGTGTGC: GCCGAAACGGTAGTGTGCC
TGCCGGGATAGGGAGCGTC: GCCGGGATAGGGAGCGTCT
TGCGAACCAGGAGCAGCTG: GCGAACCAGGAGCAGCTGA
TGCGAAGCCTACGATAGCG: GCGAAGCCTACGATAGCGT
TGCGACGTTCGAGTCTCTT: GCGACGTTCGAGTCTCTTC
TGCGAGACACCAGACCCAT: GCGAGACACCAGACCCATA
TGCGAGTAGACCTTAGAAT: GCGAGTAGACCTTAGAATA
TGCGCCGCGTTTCACGGTA: GCGCCGCGTTTCACGGTAC
TGCGCGCGAATACAGGTAC: GCGCGCGAATACAGGTACC
TGCGGCCGAGCGAGGTTGT: GCGGCCGAGCGAGGTTGTA
TGCGTCGGAGGCATGTTCG: GCGTCGGAGGCATGTTCGG
TGCGTCTATAATGTGGCTA: GCGTCTATAATGTGGCTAA
TGCGTTATTTATGTTCAAA: GCGTTATTTATGTTCAAAA
TGCGTTCTACCTGTCGTAC: GCGTTCTACCTGTCGTACG
TGCTACCTGGACGTAACGA: GCTACCTGGACGTAACGAT
TGCTAGCGATCTCGATGGG: GCTAGCGATCTCGATGGGT
TGCTATCCCTAATGTACAG: GCTATCCCTAATGTACAGG
TGCTCGGGATTAGTCAGTA: GCTCGGGATTAGTCAGTAG
TGCTCTGAACATGTACTAC: GCTCTGAACATGTACTACT
TGCTCTGGGGCCACTTCCT: GCTCTGGGGCCACTTCCTT
TGGAAACTATAAGGGCCAC: GGAAACTATAAGGGCCACA
TGGAACGGGCGATCTCCCC: GGAACGGGCGATCTCCCCT
TGGAAGCGCAGGGGATGTT: GGAAGCGCAGGGGATGTTC
TGGACGAACCGGTCGCCTA: GGACGAACCGGTCGCCTAC
TGGACGTAACGATCCGAGC: GGACGTAACGATCCGAGCG
TGGAGATCCTGGCCCCCTG: GGAGATCCTGGCCCCCTGA
TGGAGCCGGAGTTTGAGCT: GGAGCCGGAGTTTGAGCTT
TGGAGGATACCTATTCATT: GGAGGATACCTATTCATTT
TGGATCTGGCGAATATGAG: GGATCTGGCGAATATGAGA
TGGATGGAGCCGGAGTTTG: GGATGGAGCCGGAGTTTGA
TGGCAGCCGGACAGGATCG: GGCAGCCGGACAGGATCGC
TGGCCATTCCCGAATAGTG: GGCCATTCCCGAATAGTGA
TGGCCCAGTTCAATCCTTT: GGCCCAGTTCAATCCTTTG
TGGCCCCCTGAAGACATAA: GGCCCCCTGAAGACATAAT
TGGCGAATATGAGAAATCG: GGCGAATATGAGAAATCGA
TGGCTAAAAGATCGGGTGT: GGCTAAAAGATCGGGTGTT
TGGCTCACTACATCTCGGC: GGCTCACTACATCTCGGCA
TGGGAAGTCTCTTACTGCA: GGGAAGTCTCTTACTGCAC
TGGGAGAAGTGGATCTGGC: GGGAGAAGTGGATCTGGCG
TGGGATCATCCCGACCACC: GGGATCATCCCGACCACCA
TGGGGAATTGATTGCAACT: GGGGAATTGATTGCAACTG
TGGGGAGGGGAACCGTTAA: GGGGAGGGGAACCGTTAAC
TGGGGCCACTTCCTTTAGG: GGGGCCACTTCCTTTAGGT
TGGGTACATTAGGCTGTAA: GGGTACATTAGGCTGTAAG
TGGGTCGGGCTGAGTCCAC: GGGTCGGGCTGAGTCCACA
TGGGTTACAATTGTTTATG: GGGTTACAATTGTTTATGT
TGGTGCGTTCTACCTGTCG: GGTGCGTTCTACCTGTCGT
TGGTGCTATCCCTAATGTA: GGTGCTATCCCTAATGTAC
TGGTTGAGTTAGTAAGGTC: GGTTGAGTTAGTAAGGTCA
TGGTTTGATGTCTTCTCCC: GGTTTGATGTCTTCTCCCC
TGTAAGATCCAGAGTACTG: GTAAGATCCAGAGTACTGT
TGTAAGTATGGAGGATACC: GTAAGTATGGAGGATACCT
TGTACAGGGCCTGACCATG: GTACAGGGCCTGACCATGG
TGTACTACTCCCCACAACT: GTACTACTCCCCACAACTC
TGTACTAGGGTTAAAGGGC: GTACTAGGGTTAAAGGGCA
TGTAGATGGATGGAGCCGG: GTAGATGGATGGAGCCGGA
TGTAGCCGCTCAGTTCTAC: GTAGCCGCTCAGTTCTACC
TGTAGCGGAAGCTCACCAA: GTAGCGGAAGCTCACCAAC
TGTAGCTACTCCATCCGAC: GTAGCTACTCCATCCGACG
TGTATATATTTACGGGGCC: GTATATATTTACGGGGCCC
TGTATTATTGCGTTATTTA: GTATTATTGCGTTATTTAT
TGTCACTTGTTCCGATCTG: GTCACTTGTTCCGATCTGT
TGTCCGGGCTACTTGCGAG: GTCCGGGCTACTTGCGAGT
TGTCGTACGTGCGTCGGAG: GTCGTACGTGCGTCGGAGG
TGTCTTCTCCCCCGGCATG: GTCTTCTCCCCCGGCATGC
TGTCTTGGCCATTCCCGAA: GTCTTGGCCATTCCCGAAT
TGTGCAGTTCGGCAGGTAT: GTGCAGTTCGGCAGGTATC
TGTGCCAGCCGAGACCGAA: GTGCCAGCCGAGACCGAAT
TGTGCCCATCGTCATCCCG: GTGCCCATCGTCATCCCGA
TGTGCGAGACACCAGACCC: GTGCGAGACACCAGACCCA
TGTGGCTAAAAGATCGGGT: GTGGCTAAAAGATCGGGTG
TGTGTTGTGCAGTTCGGCA: GTGTTGTGCAGTTCGGCAG
TGTTACGCCAGAACATTCT: GTTACGCCAGAACATTCTC
TGTTCAAAAAGACATAGGA: GTTCAAAAAGACATAGGAT
TGTTCCGATCTGTAGATGG: GTTCCGATCTGTAGATGGA
TGTTCGCACCACCGACGCG: GTTCGCACCACCGACGCGC
TGTTCGGAACATTTCTGGG: GTTCGGAACATTTCTGGGA
TGTTCGTATAGTCCAAGGT: GTTCGTATAGTCCAAGGTA
TGTTCTTCAACATCTAACC: GTTCTTCAACATCTAACCC
TGTTGCGCCGCGTTTCACG: GTTGCGCCGCGTTTCACGG
TGTTGTGCAGTTCGGCAGG: GTTGTGCAGTTCGGCAGGT
TGTTTATGTTGCGCCGCGT: GTTTATGTTGCGCCGCGTT
TGTTTCGTGAAATTACCAG: GTTTCGTGAAATTACCAGT
TGTTTGCACTTTTCGGGTC: GTTTGCACTTTTCGGGTCT
TTAAAGGGCAAGCTGGAAA: TAAAGGGCAAGCTGGAAAC
TTAACGCTCATCCCGACCA: TAACGCTCATCCCGACCAC
TTAATGGGAAGTCTCTTAC: TAATGGGAAGTCTCTTACT
TTACAATAAGAGCCATTGT: TACAATAAGAGCCATTGTC
TTACAATTGTTTATGTTGC: TACAATTGTTTATGTTGCG
TTACCAGTGCTAGCGATCT: TACCAGTGCTAGCGATCTC
TTACGCCAGAACATTCTCA: TACGCCAGAACATTCTCAT
TTACGGGGCCCTACGGCCT: TACGGGGCCCTACGGCCTT
TTACTAGCCCACCCAGACC: TACTAGCCCACCCAGACCT
TTACTGCACTGTTCGCACC: TACTGCACTGTTCGCACCA
TTAGAATACCACGCTTATA: TAGAATACCACGCTTATAG
TTAGGCTGTAAGATCCAGA: TAGGCTGTAAGATCCAGAG
TTAGGTCCTGGCCCAGTTC: TAGGTCCTGGCCCAGTTCA
TTAGTAAGGTCAGATCAGC: TAGTAAGGTCAGATCAGCG
TTAGTCAGTAGACCTGTGC: TAGTCAGTAGACCTGTGCC
TTAGTTCATCCCGACCACC: TAGTTCATCCCGACCACCA
TTATAGATCAAGCACAGTA: TATAGATCAAGCACAGTAC
TTATAGCTCTGGACGAACC: TATAGCTCTGGACGAACCG
TTATGTTCAAAAAGACATA: TATGTTCAAAAAGACATAG
TTATGTTGCGCCGCGTTTC: TATGTTGCGCCGCGTTTCA
TTATTACTAGCCCACCCAG: TATTACTAGCCCACCCAGA
TTATTGCGTTATTTATGTT: TATTGCGTTATTTATGTTC
TTATTTATGTTCAAAAAGA: TATTTATGTTCAAAAAGAC
TTCAAAAAGACATAGGATT: TCAAAAAGACATAGGATTC
TTCAACATCTAACCCCGCG: TCAACATCTAACCCCGCGC
TTCAATCCTTTGTAGCCGC: TCAATCCTTTGTAGCCGCT
TTCACGGTACGAACTACAG: TCACGGTACGAACTACAGG
TTCATCCCGACCACCAAGG: TCATCCCGACCACCAAGGT
TTCATTGGTGCTATCCCTA: TCATTGGTGCTATCCCTAA
TTCATTTCTGCTACCTGGA: TCATTTCTGCTACCTGGAC
TTCCAATGAATAAGAATCA: TCCAATGAATAAGAATCAA
TTCCATAAACTCTTCATTG: TCCATAAACTCTTCATTGG
TTCCCGAATAGTGAGTGTA: TCCCGAATAGTGAGTGTAA
TTCCGACCTAGTTTTTGCT: TCCGACCTAGTTTTTGCTC
TTCCGATCTGTAGATGGAT: TCCGATCTGTAGATGGATG
TTCCGGCCAAATTTGGAAG: TCCGGCCAAATTTGGAAGC
TTCCTCAGGGAAGGACTAC: TCCTCAGGGAAGGACTACG
TTCCTGCAGAATGGTGCGT: TCCTGCAGAATGGTGCGTT
TTCCTTTAGGTCCTGGCCC: TCCTTTAGGTCCTGGCCCA
TTCGACGTATCCCCAAATC: TCGACGTATCCCCAAATCA
TTCGAGTCTCTTCGTCTAA: TCGAGTCTCTTCGTCTAAA
TTCGCACCACCGACGCGCT: TCGCACCACCGACGCGCTA
TTCGGAACATTTCTGGGAG: TCGGAACATTTCTGGGAGA
TTCGGCAGGTATCTACACT: TCGGCAGGTATCTACACTC
TTCGGCGACCCGTGCTCGG: TCGGCGACCCGTGCTCGGG
TTCGGGTCTACGACGTTCT: TCGGGTCTACGACGTTCTA
TTCGGTGTACTAGGGTTAA: TCGGTGTACTAGGGTTAAA
TTCGTATAGTCCAAGGTAC: TCGTATAGTCCAAGGTACA
TTCGTCTAAACGCATAACT: TCGTCTAAACGCATAACTC
TTCGTGAAATTACCAGTGC: TCGTGAAATTACCAGTGCT
TTCTAAAACTGCCATAAAG: TCTAAAACTGCCATAAAGC
TTCTACCGGCAGTGTTACG: TCTACCGGCAGTGTTACGC
TTCTACCTGTCGTACGTGC: TCTACCTGTCGTACGTGCG
TTCTCATCTATTGTAGCTA: TCTCATCTATTGTAGCTAC
TTCTCCCCCGGCATGCACA: TCTCCCCCGGCATGCACAT
TTCTGCTACCTGGACGTAA: TCTGCTACCTGGACGTAAC
TTCTGGGAGAAGTGGATCT: TCTGGGAGAAGTGGATCTG
TTCTTCAACATCTAACCCC: TCTTCAACATCTAACCCCG
TTCTTCCTGCAGAATGGTG: TCTTCCTGCAGAATGGTGC
TTCTTTTGAAGGATGCCGG: TCTTTTGAAGGATGCCGGG
TTGAACCCGACGAACCGGT: TGAACCCGACGAACCGGTC
TTGAAGGATGCCGGGATAG: TGAAGGATGCCGGGATAGG
TTGACGAACCGGTCGCCTA: TGACGAACCGGTCGCCTAC
TTGAGACGAACACAGGCTT: TGAGACGAACACAGGCTTT
TTGAGCTTTTTGGGGAATT: TGAGCTTTTTGGGGAATTG
TTGAGTCGGGTCTGCATCA: TGAGTCGGGTCTGCATCAT
TTGAGTTAGTAAGGTCAGA: TGAGTTAGTAAGGTCAGAT
TTGATGTCTTCTCCCCCGG: TGATGTCTTCTCCCCCGGC
TTGATTGCAACTGGGTCGG: TGATTGCAACTGGGTCGGG
TTGCAACTGGGTCGGGCTG: TGCAACTGGGTCGGGCTGA
TTGCACTTTTCGGGTCTAC: TGCACTTTTCGGGTCTACG
TTGCAGACCAAATACCAAA: TGCAGACCAAATACCAAAA
TTGCATCGTGCAGGGCCCA: TGCATCGTGCAGGGCCCAC
TTGCGAACCAGGAGCAGCT: TGCGAACCAGGAGCAGCTG
TTGCGAGTAGACCTTAGAA: TGCGAGTAGACCTTAGAAT
TTGCGCCGCGTTTCACGGT: TGCGCCGCGTTTCACGGTA
TTGCGTCTATAATGTGGCT: TGCGTCTATAATGTGGCTA
TTGCGTTATTTATGTTCAA: TGCGTTATTTATGTTCAAA
TTGCTCTGAACATGTACTA: TGCTCTGAACATGTACTAC
TTGGAAGCGCAGGGGATGT: TGGAAGCGCAGGGGATGTT
TTGGCCATTCCCGAATAGT: TGGCCATTCCCGAATAGTG
TTGGCTCACTACATCTCGG: TGGCTCACTACATCTCGGC
TTGGGATCATCCCGACCAC: TGGGATCATCCCGACCACC
TTGGGGAATTGATTGCAAC: TGGGGAATTGATTGCAACT
TTGGGTACATTAGGCTGTA: TGGGTACATTAGGCTGTAA
TTGGTGCTATCCCTAATGT: TGGTGCTATCCCTAATGTA
TTGGTTGAGTTAGTAAGGT: TGGTTGAGTTAGTAAGGTC
TTGTAGCCGCTCAGTTCTA: TGTAGCCGCTCAGTTCTAC
TTGTAGCTACTCCATCCGA: TGTAGCTACTCCATCCGAC
TTGTATATATTTACGGGGC: TGTATATATTTACGGGGCC
TTGTATTATTGCGTTATTT: TGTATTATTGCGTTATTTA
TTGTCTTGGCCATTCCCGA: TGTCTTGGCCATTCCCGAA
TTGTGCAGTTCGGCAGGTA: TGTGCAGTTCGGCAGGTAT
TTGTTCCGATCTGTAGATG: TGTTCCGATCTGTAGATGG
TTGTTTATGTTGCGCCGCG: TGTTTATGTTGCGCCGCGT
TTTACGGGGCCCTACGGCC: TTACGGGGCCCTACGGCCT
TTTAGGTCCTGGCCCAGTT: TTAGGTCCTGGCCCAGTTC
TTTATGTTCAAAAAGACAT: TTATGTTCAAAAAGACATA
TTTATGTTGCGCCGCGTTT: TTATGTTGCGCCGCGTTTC
TTTCACGGTACGAACTACA: TTCACGGTACGAACTACAG
TTTCCGACCTAGTTTTTGC: TTCCGACCTAGTTTTTGCT
TTTCGGGTCTACGACGTTC: TTCGGGTCTACGACGTTCT
TTTCGTGAAATTACCAGTG: TTCGTGAAATTACCAGTGC
TTTCTGCTACCTGGACGTA: TTCTGCTACCTGGACGTAA
TTTCTGGGAGAAGTGGATC: TTCTGGGAGAAGTGGATCT
TTTGAACCCGACGAACCGG: TTGAACCCGACGAACCGGT
TTTGAAGGATGCCGGGATA: TTGAAGGATGCCGGGATAG
TTTGAGACGAACACAGGCT: TTGAGACGAACACAGGCTT
TTTGAGCTTTTTGGGGAAT: TTGAGCTTTTTGGGGAATT
TTTGATGTCTTCTCCCCCG: TTGATGTCTTCTCCCCCGG
TTTGCACTTTTCGGGTCTA: TTGCACTTTTCGGGTCTAC
TTTGCTCTGAACATGTACT: TTGCTCTGAACATGTACTA
TTTGGAAGCGCAGGGGATG: TTGGAAGCGCAGGGGATGT
TTTGGGATCATCCCGACCA: TTGGGATCATCCCGACCAC
TTTGGGGAATTGATTGCAA: TTGGGGAATTGATTGCAAC
TTTGTAGCCGCTCAGTTCT: TTGTAGCCGCTCAGTTCTA
TTTGTATTATTGCGTTATT: TTGTATTATTGCGTTATTT
TTTTCGGGTCTACGACGTT: TTTCGGGTCTACGACGTTC
TTTTGAACCCGACGAACCG: TTTGAACCCGACGAACCGG
TTTTGAAGGATGCCGGGAT: TTTGAAGGATGCCGGGATA
TTTTGCTCTGAACATGTAC: TTTGCTCTGAACATGTACT
TTTTGGGATCATCCCGACC: TTTGGGATCATCCCGACCA
TTTTGGGGAATTGATTGCA: TTTGGGGAATTGATTGCAA
TTTTGTATTATTGCGTTAT: TTTGTATTATTGCGTTATT
TTTTTGCTCTGAACATGTA: TTTTGCTCTGAACATGTAC
TTTTTGGGATCATCCCGAC: TTTTGGGATCATCCCGACC
TTTTTGGGGAATTGATTGC: TTTTGGGGAATTGATTGCA
TTTTTGTATTATTGCGTTA: TTTTGTATTATTGCGTTAT
TTTTTTGTATTATTGCGTT: TTTTTGTATTATTGCGTTA
TTTTTTTGTATTATTGCGT: TTTTTTGTATTATTGCGTT
