GGTGCGCTAACGGTGATGCATGGA: GTGCGCTAACGGTGATGCATGGAC
GGAAAATACCGGGCAATAGTGACA: GAAAATACCGGGCAATAGTGACAA
AAAGTCCTTTATTTGCGCACGGTT: AAGTCCTTTATTTGCGCACGGTTA
TTGGGACGAATCTAGCACCAAAGC: TGGGACGAATCTAGCACCAAAGCT
CAGGACCTCAGTGTGAGGTTAAGC: AGGACCTCAGTGTGAGGTTAAGCT
TGCTATACAGGTGTCCCACATACT: GCTATACAGGTGTCCCACATACTG
TGTTCTTATAGTATTACTGGTATA: GTTCTTATAGTATTACTGGTATAC
TTTAGCCGAATGTTTCTCACTTGA: TTAGCCGAATGTTTCTCACTTGAT
TATCAATGTTGACATCAAACGTTA: ATCAATGTTGACATCAAACGTTAT
GCAATGCTCACTCGGTAAGTAAGC: CAATGCTCACTCGGTAAGTAAGCG
CAAGTGGGCGCTTCTGCTATACAG: AAGTGGGCGCTTCTGCTATACAGG
TTTACTTATCTGAGCCATGACTTA: TTACTTATCTGAGCCATGACTTAC
TACTTATCTGAGCCATGACTTACA: ACTTATCTGAGCCATGACTTACAA
ACTTCGGTCCGAGGCAGCAATGCT: CTTCGGTCCGAGGCAGCAATGCTC
AGTATCAATGTTGACATCAAACGT: GTATCAATGTTGACATCAAACGTT
GCGTTCCTGAATGCAGTTCCTAAT: CGTTCCTGAATGCAGTTCCTAATC
TCAATGTTGACATCAAACGTTATG: CAATGTTGACATCAAACGTTATGC
TAAATGGGTTAGGGAGGTGTTCTT: AAATGGGTTAGGGAGGTGTTCTTA
TTGAACGTTGATGTAAGCACATTG: TGAACGTTGATGTAAGCACATTGT
CCGGCGTGAGCACGTATTCCTCTC: CGGCGTGAGCACGTATTCCTCTCA
GTGTCCAAAAGTTGTGCGTAAATG: TGTCCAAAAGTTGTGCGTAAATGG
TGCGTGTCCAAAAGTTGTGCGTAA: GCGTGTCCAAAAGTTGTGCGTAAA
GTTGCGGCATAGATGGTTGGATGC: TTGCGGCATAGATGGTTGGATGCA
CCAACAGGGCGAACATGTGTTTGT: CAACAGGGCGAACATGTGTTTGTG
GAACAGGATTAATCCATTGGCGAG: AACAGGATTAATCCATTGGCGAGT
AGGGATATTGGTTGTCCTACTTCA: GGGATATTGGTTGTCCTACTTCAC
ATTCCCCCGTGCGGCCGTCTGCGT: TTCCCCCGTGCGGCCGTCTGCGTG
GACAACCAGTTGTCTCAGGTAAAT: ACAACCAGTTGTCTCAGGTAAATT
AACACGCACATGTTTACTATACTA: ACACGCACATGTTTACTATACTAG
GCTGAATCGTTTTCGTAGCATGGA: CTGAATCGTTTTCGTAGCATGGAA
TCTGCAGAGTCAGTAGCCTCTATA: CTGCAGAGTCAGTAGCCTCTATAC
CGCTACTTTGTCCACGAATCTTTC: GCTACTTTGTCCACGAATCTTTCC
CATGGACAGAGTTTTAGCCGAATG: ATGGACAGAGTTTTAGCCGAATGT
GTAGGTGTATGAATCGTGTAACAC: TAGGTGTATGAATCGTGTAACACG
ATACTAGTGATAACCGAGCCCCAA: TACTAGTGATAACCGAGCCCCAAC
GGATTAATCCATTGGCGAGTTGAA: GATTAATCCATTGGCGAGTTGAAA
GTCCGAGGCAGCAATGCTCACTCG: TCCGAGGCAGCAATGCTCACTCGG
TCCACAACCAAAGTCATTGTTAGG: CCACAACCAAAGTCATTGTTAGGG
CTCGTCCTTAACAAGTTAAGCGAT: TCGTCCTTAACAAGTTAAGCGATT
CCAACCAGGTGACCCACGGTGTGT: CAACCAGGTGACCCACGGTGTGTA
AGAGGGGCAAAGCACAGGCCGAGA: GAGGGGCAAAGCACAGGCCGAGAG
CGGTGATGCATGGACAGAGTTTTA: GGTGATGCATGGACAGAGTTTTAG
ATGTCACTTCGGTCCGAGGCAGCA: TGTCACTTCGGTCCGAGGCAGCAA
TTCGACGCGCCTTACTGGTGTCTC: TCGACGCGCCTTACTGGTGTCTCT
CCGGCCCGTCAGCGTTCAGTTAGA: CGGCCCGTCAGCGTTCAGTTAGAA
CCGAGGAATCCGGATGAATCTCTG: CGAGGAATCCGGATGAATCTCTGC
GCGTGTCCAAAAGTTGTGCGTAAA: CGTGTCCAAAAGTTGTGCGTAAAT
GAAGAGACTAACACTGTTTTTTTG: AAGAGACTAACACTGTTTTTTTGC
AGGTGACCCACGGTGTGTATGCAT: GGTGACCCACGGTGTGTATGCATA
GCAGATACCGGCGAACATGCCGAT: CAGATACCGGCGAACATGCCGATA
AACCGTCAGACTGGTCAGTGAAAC: ACCGTCAGACTGGTCAGTGAAACG
CGCCTCGTTGGCCTCTTCCACTAA: GCCTCGTTGGCCTCTTCCACTAAC
CACTAACACACCTTGGTGCAGGAC: ACTAACACACCTTGGTGCAGGACC
CCGAGGCAGCAATGCTCACTCGGT: CGAGGCAGCAATGCTCACTCGGTA
GCACGTGCTGCTTTATCCGGCCCG: CACGTGCTGCTTTATCCGGCCCGT
TTCCTAATCAGACTGTTTAGGGCT: TCCTAATCAGACTGTTTAGGGCTT
AGGTGTATGAATCGTGTAACACGC: GGTGTATGAATCGTGTAACACGCT
GTGTGAGGTTAAGCTTTTGCTGGT: TGTGAGGTTAAGCTTTTGCTGGTG
GTGGCACTCTCGTCCTTAACAAGT: TGGCACTCTCGTCCTTAACAAGTT
ACAATGTCACTTCGGTCCGAGGCA: CAATGTCACTTCGGTCCGAGGCAG
CGTTTTCGTAGCATGGAAAGAACC: GTTTTCGTAGCATGGAAAGAACCT
CATAGATGGTTGGATGCAGAAGGA: ATAGATGGTTGGATGCAGAAGGAC
TCAGTAGAAATAGGAACACACGAG: CAGTAGAAATAGGAACACACGAGT
CCTGTTTCCGATAAGGTGCACCTA: CTGTTTCCGATAAGGTGCACCTAA
CGAGCCCCAACAGGTGGATAAACT: GAGCCCCAACAGGTGGATAAACTA
TGACTTGCGCTTCGCGGAAGAACA: GACTTGCGCTTCGCGGAAGAACAG
TCAGTGAAACGGAACACTTAAACG: CAGTGAAACGGAACACTTAAACGG
GAAAAAAGTACGTTAACTTGGTAG: AAAAAAGTACGTTAACTTGGTAGG
CGTTAACTTGGTAGGTGTATGAAT: GTTAACTTGGTAGGTGTATGAATC
CACGGACAACCAGTTGTCTCAGGT: ACGGACAACCAGTTGTCTCAGGTA
CAGAAGTATAGCTGACAATGTCAC: AGAAGTATAGCTGACAATGTCACT
ACAAAGGGTTGGGCAAATAACTAC: CAAAGGGTTGGGCAAATAACTACA
AATACCCTCGGAGGCCCAGCCGTG: ATACCCTCGGAGGCCCAGCCGTGT
CGGGCGGGTATTTCCTGTGGCCAA: GGGCGGGTATTTCCTGTGGCCAAG
AATCTAGCACCAAAGCTCCGTACC: ATCTAGCACCAAAGCTCCGTACCC
ACATGTGTTTGTGTAGCTCAGATA: CATGTGTTTGTGTAGCTCAGATAT
ATCGTGCGCCGACTTCATCTACAA: TCGTGCGCCGACTTCATCTACAAT
ATGGCGACCCGTTCCAACCTGTCA: TGGCGACCCGTTCCAACCTGTCAC
CATGTTGCACGTTTGTCCAATTCA: ATGTTGCACGTTTGTCCAATTCAA
CCAGTACAGGTTCTGCAGAAGTAT: CAGTACAGGTTCTGCAGAAGTATA
CGTCACATACAAACATACTAGTGA: GTCACATACAAACATACTAGTGAT
GTTTCTCACTTGATCCACAGGTTA: TTTCTCACTTGATCCACAGGTTAG
GGAGGTGTTCTTATAGTATTACTG: GAGGTGTTCTTATAGTATTACTGG
GAATCTCTGCAGAGTCAGTAGCCT: AATCTCTGCAGAGTCAGTAGCCTC
GAAGGACCCCTTAGATCTAGCTGC: AAGGACCCCTTAGATCTAGCTGCA
GTTGGGCAAATAACTACAATGCTG: TTGGGCAAATAACTACAATGCTGG
GTAAGTAAGCGTGGCACTCTCGTC: TAAGTAAGCGTGGCACTCTCGTCC
CAGCCAGGTTGCGGCATAGATGGT: AGCCAGGTTGCGGCATAGATGGTT
TTCTCGCACGTGCTGCTTTATCCG: TCTCGCACGTGCTGCTTTATCCGG
CTTGTAAGAGTTGGGACGAATCTA: TTGTAAGAGTTGGGACGAATCTAG
GCAATAGTGACAAAGGGTTGGGCA: CAATAGTGACAAAGGGTTGGGCAA
ACGTTGATGTAAGCACATTGTACG: CGTTGATGTAAGCACATTGTACGA
TTCCCGACTATTCGGTACAGAATA: TCCCGACTATTCGGTACAGAATAC
CGCTCAGGAACCCGTATTTCAGTA: GCTCAGGAACCCGTATTTCAGTAG
TACTAGTGATAACCGAGCCCCAAC: ACTAGTGATAACCGAGCCCCAACA
CCTACGATTATGCCTGGCCACTTC: CTACGATTATGCCTGGCCACTTCT
GATGCAGAAGGACCCCTTAGATCT: ATGCAGAAGGACCCCTTAGATCTA
TCTATACAGTGATTTACGCTTAGG: CTATACAGTGATTTACGCTTAGGT
CAACCTGTCACGTAAAAGACCTCA: AACCTGTCACGTAAAAGACCTCAA
AACAGACGCAGATACCGGCGAACA: ACAGACGCAGATACCGGCGAACAT
ACACTTAAACGGGCGGGTATTTCC: CACTTAAACGGGCGGGTATTTCCT
GATAACCGAGCCCCAACAGGTGGA: ATAACCGAGCCCCAACAGGTGGAT
TGCAGAAGTATAGCTGACAATGTC: GCAGAAGTATAGCTGACAATGTCA
GTCTCAGGTAAATTGAGACTATAG: TCTCAGGTAAATTGAGACTATAGA
AATCTTTCCCCTCCCTCAGCCAGG: ATCTTTCCCCTCCCTCAGCCAGGT
GTCAGTGAAACGGAACACTTAAAC: TCAGTGAAACGGAACACTTAAACG
TTATTTGCGCACGGTTAGAGGCAT: TATTTGCGCACGGTTAGAGGCATC
AGGCATCTGCGTTCCTGAATGCAG: GGCATCTGCGTTCCTGAATGCAGT
ACCCTCGGAGGCCCAGCCGTGTGA: CCCTCGGAGGCCCAGCCGTGTGAA
CCGACTATTCGGTACAGAATACCA: CGACTATTCGGTACAGAATACCAG
GTTAGGGAGGTGTTCTTATAGTAT: TTAGGGAGGTGTTCTTATAGTATT
CGACTATTCGGTACAGAATACCAG: GACTATTCGGTACAGAATACCAGT
CTGACATTCCCCCGTGCGGCCGTC: TGACATTCCCCCGTGCGGCCGTCT
TCTCCACTTATTATTGCGTGGCAT: CTCCACTTATTATTGCGTGGCATG
GTAGGCACGAGGGATATTGGTTGT: TAGGCACGAGGGATATTGGTTGTC
TGCACCATCAAAAGATAACACGCA: GCACCATCAAAAGATAACACGCAC
GCTGACATTCCCCCGTGCGGCCGT: CTGACATTCCCCCGTGCGGCCGTC
CATAAGCGGTTTGCTGGCTTGGGC: ATAAGCGGTTTGCTGGCTTGGGCA
ATGTGGATACGTCTCTAATACCCT: TGTGGATACGTCTCTAATACCCTC
GTCCTTAACAAGTTAAGCGATTTT: TCCTTAACAAGTTAAGCGATTTTA
AAGCTTTTGCTGGTGTTTCTTGGA: AGCTTTTGCTGGTGTTTCTTGGAT
TTATTATTGCGTGGCATGCGTGAC: TATTATTGCGTGGCATGCGTGACC
TGTTTGTGTAGCTCAGATATTTTG: GTTTGTGTAGCTCAGATATTTTGC
CGATAAGGTGCACCTAACCTTTTC: GATAAGGTGCACCTAACCTTTTCA
GTCCACGGTGCGCTAACGGTGATG: TCCACGGTGCGCTAACGGTGATGC
CCACGGTGTGTATGCATAAGCGGT: CACGGTGTGTATGCATAAGCGGTT
TCGTTGGCCTCTTCCACTAACACA: CGTTGGCCTCTTCCACTAACACAC
TATGGATATTCCGCCAGATATTCC: ATGGATATTCCGCCAGATATTCCC
GCCCTCGGATCCCATAACATCAGA: CCCTCGGATCCCATAACATCAGAC
ATTGGTTGTCCTACTTCACCGGCT: TTGGTTGTCCTACTTCACCGGCTA
ACCCACGGTGTGTATGCATAAGCG: CCCACGGTGTGTATGCATAAGCGG
ATTCAATCGCTACTTTGTCCACGA: TTCAATCGCTACTTTGTCCACGAA
TTCCTGAATGCAGTTCCTAATCAG: TCCTGAATGCAGTTCCTAATCAGA
CCTCGTTGGCCTCTTCCACTAACA: CTCGTTGGCCTCTTCCACTAACAC
ATGATGGCGACCCGTTCCAACCTG: TGATGGCGACCCGTTCCAACCTGT
TCCACTAACACACCTTGGTGCAGG: CCACTAACACACCTTGGTGCAGGA
CCATCAAAAGATAACACGCACATG: CATCAAAAGATAACACGCACATGT
GTGTCTCTCCGGCGCCACCGCCTC: TGTCTCTCCGGCGCCACCGCCTCG
CTCGGAGGCCCAGCCGTGTGAAAA: TCGGAGGCCCAGCCGTGTGAAAAA
AGGTGCACCTAACCTTTTCACAAA: GGTGCACCTAACCTTTTCACAAAT
TTGGACGTTTCTCGCACGTGCTGC: TGGACGTTTCTCGCACGTGCTGCT
ACCGCCTCGTTGGCCTCTTCCACT: CCGCCTCGTTGGCCTCTTCCACTA
CAAGGACACAAGTGGGCGCTTCTG: AAGGACACAAGTGGGCGCTTCTGC
GGATGAATCTCTGCAGAGTCAGTA: GATGAATCTCTGCAGAGTCAGTAG
ATGAGCACCGGTCCCCGTACTGTC: TGAGCACCGGTCCCCGTACTGTCA
TAGTATTACTGGTATACTCTCCAC: AGTATTACTGGTATACTCTCCACT
GAGGGATATTGGTTGTCCTACTTC: AGGGATATTGGTTGTCCTACTTCA
TGAGACTATAGAGGCCCGGCGTGA: GAGACTATAGAGGCCCGGCGTGAG
ACGGTGTGTATGCATAAGCGGTTT: CGGTGTGTATGCATAAGCGGTTTG
CTAGAGGGGCAAAGCACAGGCCGA: TAGAGGGGCAAAGCACAGGCCGAG
ACTTCATCTACAATACGCAAGGAC: CTTCATCTACAATACGCAAGGACA
ACCTCAGTGTGAGGTTAAGCTTTT: CCTCAGTGTGAGGTTAAGCTTTTG
CAAATAACTACAATGCTGGAAAGT: AAATAACTACAATGCTGGAAAGTC
TGCGAGTATCAATGTTGACATCAA: GCGAGTATCAATGTTGACATCAAA
AAACGTTATGCGCTGAATCGTTTT: AACGTTATGCGCTGAATCGTTTTC
CCTTTTCACAAATAATTCATCGTG: CTTTTCACAAATAATTCATCGTGT
AACATTATACCTAAGCTTCAGAGT: ACATTATACCTAAGCTTCAGAGTC
ATAGATGGTTGGATGCAGAAGGAC: TAGATGGTTGGATGCAGAAGGACC
CCGTCTGCGTGTCCAAAAGTTGTG: CGTCTGCGTGTCCAAAAGTTGTGC
AGCACCGGTCCCCGTACTGTCACA: GCACCGGTCCCCGTACTGTCACAT
AAAGCTCCGTACCCCATTCGCCTC: AAGCTCCGTACCCCATTCGCCTCT
TGACAAAGGGTTGGGCAAATAACT: GACAAAGGGTTGGGCAAATAACTA
GCGGTCACTGCACAATGATGGCGA: CGGTCACTGCACAATGATGGCGAC
GCTTTTGCTGGTGTTTCTTGGATC: CTTTTGCTGGTGTTTCTTGGATCG
AATTGAGACTATAGAGGCCCGGCG: ATTGAGACTATAGAGGCCCGGCGT
TTATACCTAAGCTTCAGAGTCCGA: TATACCTAAGCTTCAGAGTCCGAG
CGATACGTCACATACAAACATACT: GATACGTCACATACAAACATACTA
GGGTTGGGCAAATAACTACAATGC: GGTTGGGCAAATAACTACAATGCT
TGGGCGCTTCTGCTATACAGGTGT: GGGCGCTTCTGCTATACAGGTGTC
CTGGTGTCTCTCCGGCGCCACCGC: TGGTGTCTCTCCGGCGCCACCGCC
ACTTGCGCTTCGCGGAAGAACAGG: CTTGCGCTTCGCGGAAGAACAGGA
TAAATTGAGACTATAGAGGCCCGG: AAATTGAGACTATAGAGGCCCGGC
CAGGTGTAGAGAATCAGTTGAACG: AGGTGTAGAGAATCAGTTGAACGT
AAGCGGTTTGCTGGCTTGGGCAAG: AGCGGTTTGCTGGCTTGGGCAAGG
ACTGTTTTTTTGCGAGTATCAATG: CTGTTTTTTTGCGAGTATCAATGT
GTTTGTGACGCCCGCTCAGGAACC: TTTGTGACGCCCGCTCAGGAACCC
GCCGAATGTTTCTCACTTGATCCA: CCGAATGTTTCTCACTTGATCCAC
ACTGTTTAGGGCTTCGACGCGCCT: CTGTTTAGGGCTTCGACGCGCCTT
TATCTGAGCCATGACTTACAATGC: ATCTGAGCCATGACTTACAATGCG
TTTCACAAATAATTCATCGTGTCG: TTCACAAATAATTCATCGTGTCGT
TTGGTAGGTGTATGAATCGTGTAA: TGGTAGGTGTATGAATCGTGTAAC
GATCTAGCTGCAGTTGGCGCCCAT: ATCTAGCTGCAGTTGGCGCCCATG
CCAATTCAATCGCTACTTTGTCCA: CAATTCAATCGCTACTTTGTCCAC
CCCGTGCGGCCGTCTGCGTGTCCA: CCGTGCGGCCGTCTGCGTGTCCAA
ATTCCCGACTATTCGGTACAGAAT: TTCCCGACTATTCGGTACAGAATA
CACCTAACCTTTTCACAAATAATT: ACCTAACCTTTTCACAAATAATTC
CCCGTTCCAACCTGTCACGTAAAA: CCGTTCCAACCTGTCACGTAAAAG
ACAAATAATTCATCGTGTCGTGCG: CAAATAATTCATCGTGTCGTGCGC
AGGCCCAGCCGTGTGAAAAAAGTA: GGCCCAGCCGTGTGAAAAAAGTAC
GATTTTACTTATCTGAGCCATGAC: ATTTTACTTATCTGAGCCATGACT
TATTATATGCTAACCTACTGCTGA: ATTATATGCTAACCTACTGCTGAC
TGAGCCATGACTTACAATGCGAAC: GAGCCATGACTTACAATGCGAACC
ATGCGCTGAATCGTTTTCGTAGCA: TGCGCTGAATCGTTTTCGTAGCAT
ACCAGTACAGGTTCTGCAGAAGTA: CCAGTACAGGTTCTGCAGAAGTAT
GAGAGGATCGTAGTGTAAAAACTC: AGAGGATCGTAGTGTAAAAACTCC
AGCTGCAGTTGGCGCCCATGAGCA: GCTGCAGTTGGCGCCCATGAGCAC
TACGTCACATACAAACATACTAGT: ACGTCACATACAAACATACTAGTG
TCCTTAACAAGTTAAGCGATTTTA: CCTTAACAAGTTAAGCGATTTTAC
GGCGCTTCTGCTATACAGGTGTCC: GCGCTTCTGCTATACAGGTGTCCC
CTGTTTAGGGCTTCGACGCGCCTT: TGTTTAGGGCTTCGACGCGCCTTA
AAGTGGGCGCTTCTGCTATACAGG: AGTGGGCGCTTCTGCTATACAGGT
GGTTAAGCTTTTGCTGGTGTTTCT: GTTAAGCTTTTGCTGGTGTTTCTT
GCAGTTGGCGCCCATGAGCACCGG: CAGTTGGCGCCCATGAGCACCGGT
CGAACCTTGCCATACATGTGGATA: GAACCTTGCCATACATGTGGATAC
TTGTGCGTAAATGGGTTAGGGAGG: TGTGCGTAAATGGGTTAGGGAGGT
ATAATTCATCGTGTCGTGCGCCCC: TAATTCATCGTGTCGTGCGCCCCC
TCAGCGTTCAGTTAGAAGAGACTA: CAGCGTTCAGTTAGAAGAGACTAA
GTTCCTGAATGCAGTTCCTAATCA: TTCCTGAATGCAGTTCCTAATCAG
GCACATGTTTACTATACTAGAGGG: CACATGTTTACTATACTAGAGGGG
TGTACGATGTTGGACGTTTCTCGC: GTACGATGTTGGACGTTTCTCGCA
GACGCGCCATGGAGCACACAGACT: ACGCGCCATGGAGCACACAGACTT
CATCTACAATACGCAAGGACACAA: ATCTACAATACGCAAGGACACAAG
CACCGCCTCGTTGGCCTCTTCCAC: ACCGCCTCGTTGGCCTCTTCCACT
CGCTAACGGTGATGCATGGACAGA: GCTAACGGTGATGCATGGACAGAG
CAAAGCACAGGCCGAGAGGATCGT: AAAGCACAGGCCGAGAGGATCGTA
GCACCGGTCCCCGTACTGTCACAT: CACCGGTCCCCGTACTGTCACATA
AAAGTCATTGTTAGGGATTCCACA: AAGTCATTGTTAGGGATTCCACAC
ATATTGGTTGTCCTACTTCACCGG: TATTGGTTGTCCTACTTCACCGGC
TCGTGCGCCGACTTCATCTACAAT: CGTGCGCCGACTTCATCTACAATA
AAGGCAACATTATACCTAAGCTTC: AGGCAACATTATACCTAAGCTTCA
TATTACTGGTATACTCTCCACTTA: ATTACTGGTATACTCTCCACTTAT
GACCTGTTTCCGATAAGGTGCACC: ACCTGTTTCCGATAAGGTGCACCT
ACATCAAACGTTATGCGCTGAATC: CATCAAACGTTATGCGCTGAATCG
GCACAGGCCGAGAGGATCGTAGTG: CACAGGCCGAGAGGATCGTAGTGT
TACGTCTCTAATACCCTCGGAGGC: ACGTCTCTAATACCCTCGGAGGCC
CAAAATCCTTCCACGGACAACCAG: AAAATCCTTCCACGGACAACCAGT
AATAGTGACAAAGGGTTGGGCAAA: ATAGTGACAAAGGGTTGGGCAAAT
TATTAGCACGTGGGAAAATACCGG: ATTAGCACGTGGGAAAATACCGGG
CCTCTCTCGTCAGTTTGTGACGCC: CTCTCTCGTCAGTTTGTGACGCCC
CACGAATCTTTCCCCTCCCTCAGC: ACGAATCTTTCCCCTCCCTCAGCC
TCGCCTCTACCAAAATCCTTCCAC: CGCCTCTACCAAAATCCTTCCACG
TTGACATCAAACGTTATGCGCTGA: TGACATCAAACGTTATGCGCTGAA
CGCACGGTTAGAGGCATCTGCGTT: GCACGGTTAGAGGCATCTGCGTTC
AGGTTAGTGCACCATCAAAAGATA: GGTTAGTGCACCATCAAAAGATAA
CTTAAACGGGCGGGTATTTCCTGT: TTAAACGGGCGGGTATTTCCTGTG
GACTATTCGGTACAGAATACCAGT: ACTATTCGGTACAGAATACCAGTA
CGTTGGCCTCTTCCACTAACACAC: GTTGGCCTCTTCCACTAACACACC
AATGTTGACATCAAACGTTATGCG: ATGTTGACATCAAACGTTATGCGC
TTTCTCGCACGTGCTGCTTTATCC: TTCTCGCACGTGCTGCTTTATCCG
ACAGAGTTTTAGCCGAATGTTTCT: CAGAGTTTTAGCCGAATGTTTCTC
GTCTCTCCGGCGCCACCGCCTCGT: TCTCTCCGGCGCCACCGCCTCGTT
TGACTTACAATGCGAACCTTGCCA: GACTTACAATGCGAACCTTGCCAT
CTGAGCCATGACTTACAATGCGAA: TGAGCCATGACTTACAATGCGAAC
ATAACATCAGACCTGTTTCCGATA: TAACATCAGACCTGTTTCCGATAA
CATCTGCGTTCCTGAATGCAGTTC: ATCTGCGTTCCTGAATGCAGTTCC
GTTAACTTAACAGACGCAGATACC: TTAACTTAACAGACGCAGATACCG
TTAGGGAGGTGTTCTTATAGTATT: TAGGGAGGTGTTCTTATAGTATTA
CCACACTCCTACGATTATGCCTGG: CACACTCCTACGATTATGCCTGGC
GTTAGTGCACCATCAAAAGATAAC: TTAGTGCACCATCAAAAGATAACA
AACATGTGTTTGTGTAGCTCAGAT: ACATGTGTTTGTGTAGCTCAGATA
TAAGCTTTTGCTGGTGTTTCTTGG: AAGCTTTTGCTGGTGTTTCTTGGA
TTAGCACGTGGGAAAATACCGGGC: TAGCACGTGGGAAAATACCGGGCA
GGGATATTGGTTGTCCTACTTCAC: GGATATTGGTTGTCCTACTTCACC
AGACTGTTTAGGGCTTCGACGCGC: GACTGTTTAGGGCTTCGACGCGCC
CCGTATTTCAGTAGAAATAGGAAC: CGTATTTCAGTAGAAATAGGAACA
GAGTTGAAACCGTCAGACTGGTCA: AGTTGAAACCGTCAGACTGGTCAG
ATGCCAGGTGTAGAGAATCAGTTG: TGCCAGGTGTAGAGAATCAGTTGA
AGAGAATCAGTTGAACGTTGATGT: GAGAATCAGTTGAACGTTGATGTA
CCGGCGCCACCGCCTCGTTGGCCT: CGGCGCCACCGCCTCGTTGGCCTC
TGGACAGAGTTTTAGCCGAATGTT: GGACAGAGTTTTAGCCGAATGTTT
GCTTCTGCTATACAGGTGTCCCAC: CTTCTGCTATACAGGTGTCCCACA
ATTACTGGTATACTCTCCACTTAT: TTACTGGTATACTCTCCACTTATT
GTCCCACATACTGACTTGCGCTTC: TCCCACATACTGACTTGCGCTTCG
CAACAGGTGGATAAACTAAGCGGC: AACAGGTGGATAAACTAAGCGGCT
GCAAATAACTACAATGCTGGAAAG: CAAATAACTACAATGCTGGAAAGT
CTAAGCTTCAGAGTCCGAGTATTA: TAAGCTTCAGAGTCCGAGTATTAG
TGGGACGAATCTAGCACCAAAGCT: GGGACGAATCTAGCACCAAAGCTC
ATCAAAAGATAACACGCACATGTT: TCAAAAGATAACACGCACATGTTT
CAAGTTAAGCGATTTTACTTATCT: AAGTTAAGCGATTTTACTTATCTG
CTCAGGAACCCGTATTTCAGTAGA: TCAGGAACCCGTATTTCAGTAGAA
TGAATGCAGTTCCTAATCAGACTG: GAATGCAGTTCCTAATCAGACTGT
AATGTTTCTCACTTGATCCACAGG: ATGTTTCTCACTTGATCCACAGGT
TTTTTGCGAGTATCAATGTTGACA: TTTTGCGAGTATCAATGTTGACAT
GCCGATACGTCACATACAAACATA: CCGATACGTCACATACAAACATAC
GAAAATACCGGGCAATAGTGACAA: AAAATACCGGGCAATAGTGACAAA
TGCGCTAACGGTGATGCATGGACA: GCGCTAACGGTGATGCATGGACAG
TGCGCTTCGCGGAAGAACAGGATT: GCGCTTCGCGGAAGAACAGGATTA
CCGCTCAGGAACCCGTATTTCAGT: CGCTCAGGAACCCGTATTTCAGTA
CCGTACTGTCACATAATGGATCCA: CGTACTGTCACATAATGGATCCAA
GAACGTTGATGTAAGCACATTGTA: AACGTTGATGTAAGCACATTGTAC
GGCGTGAGCACGTATTCCTCTCAT: GCGTGAGCACGTATTCCTCTCATG
TACAGGTGTCCCACATACTGACTT: ACAGGTGTCCCACATACTGACTTG
CGAGGGATATTGGTTGTCCTACTT: GAGGGATATTGGTTGTCCTACTTC
TTCGTAGCATGGAAAGAACCTTTT: TCGTAGCATGGAAAGAACCTTTTC
AATCAGACTGTTTAGGGCTTCGAC: ATCAGACTGTTTAGGGCTTCGACG
ATCTAGCTGCAGTTGGCGCCCATG: TCTAGCTGCAGTTGGCGCCCATGA
GGTTAGGGAGGTGTTCTTATAGTA: GTTAGGGAGGTGTTCTTATAGTAT
GACTTCATCTACAATACGCAAGGA: ACTTCATCTACAATACGCAAGGAC
CTAGCACCAAAGCTCCGTACCCCA: TAGCACCAAAGCTCCGTACCCCAT
CCGTTCCAACCTGTCACGTAAAAG: CGTTCCAACCTGTCACGTAAAAGA
TCCGGCGCCACCGCCTCGTTGGCC: CCGGCGCCACCGCCTCGTTGGCCT
TGCAGGACCTCAGTGTGAGGTTAA: GCAGGACCTCAGTGTGAGGTTAAG
CACGCTGAAAAAAATGCCAGGTGT: ACGCTGAAAAAAATGCCAGGTGTA
TCCCCTCCCTCAGCCAGGTTGCGG: CCCCTCCCTCAGCCAGGTTGCGGC
TTGGTGCAGGACCTCAGTGTGAGG: TGGTGCAGGACCTCAGTGTGAGGT
CAACATTATACCTAAGCTTCAGAG: AACATTATACCTAAGCTTCAGAGT
GGTCAGTGAAACGGAACACTTAAA: GTCAGTGAAACGGAACACTTAAAC
ATGCCTGGCCACTTCTGAGCCCTC: TGCCTGGCCACTTCTGAGCCCTCG
TGTCACATAATGGATCCAACCAGG: GTCACATAATGGATCCAACCAGGT
GTGCGCTAACGGTGATGCATGGAC: TGCGCTAACGGTGATGCATGGACA
GAGGACCCGAGGAATCCGGATGAA: AGGACCCGAGGAATCCGGATGAAT
CGTATTCCTCTCATGTTGCACGTT: GTATTCCTCTCATGTTGCACGTTT
AAACATTATGGATATTCCGCCAGA: AACATTATGGATATTCCGCCAGAT
GGTGGATAAACTAAGCGGCTTAGA: GTGGATAAACTAAGCGGCTTAGAC
AAGCACATTGTACGATGTTGGACG: AGCACATTGTACGATGTTGGACGT
AACGACGCGCCATGGAGCACACAG: ACGACGCGCCATGGAGCACACAGA
TGTTAGGGATTCCACACTCCTACG: GTTAGGGATTCCACACTCCTACGA
AGTCCACGGTGCGCTAACGGTGAT: GTCCACGGTGCGCTAACGGTGATG
TGTCCAATTCAATCGCTACTTTGT: GTCCAATTCAATCGCTACTTTGTC
CCCGCTCAGGAACCCGTATTTCAG: CCGCTCAGGAACCCGTATTTCAGT
CTCTCTCGTCAGTTTGTGACGCCC: TCTCTCGTCAGTTTGTGACGCCCG
AGGTTAAGCTTTTGCTGGTGTTTC: GGTTAAGCTTTTGCTGGTGTTTCT
CAGACTGGTCAGTGAAACGGAACA: AGACTGGTCAGTGAAACGGAACAC
GTAGAGAATCAGTTGAACGTTGAT: TAGAGAATCAGTTGAACGTTGATG
TATAGTATTACTGGTATACTCTCC: ATAGTATTACTGGTATACTCTCCA
ACGTTTGTCCAATTCAATCGCTAC: CGTTTGTCCAATTCAATCGCTACT
TTGTTAACTTAACAGACGCAGATA: TGTTAACTTAACAGACGCAGATAC
GCCCGGCGTGAGCACGTATTCCTC: CCCGGCGTGAGCACGTATTCCTCT
TTTCCCATCGAGCTGTTCAACTTG: TTCCCATCGAGCTGTTCAACTTGG
TATAGAGGCCCGGCGTGAGCACGT: ATAGAGGCCCGGCGTGAGCACGTA
TCGTGCGCCCCCTAGGTAAGGCGG: CGTGCGCCCCCTAGGTAAGGCGGT
CAGGAACCCGTATTTCAGTAGAAA: AGGAACCCGTATTTCAGTAGAAAT
GTACGTTAACTTGGTAGGTGTATG: TACGTTAACTTGGTAGGTGTATGA
CTTACTGGTGTCTCTCCGGCGCCA: TTACTGGTGTCTCTCCGGCGCCAC
GCTTCGCGGAAGAACAGGATTAAT: CTTCGCGGAAGAACAGGATTAATC
TAAGGTGCACCTAACCTTTTCACA: AAGGTGCACCTAACCTTTTCACAA
TCTTTCCCCTCCCTCAGCCAGGTT: CTTTCCCCTCCCTCAGCCAGGTTG
TCTAATACCCTCGGAGGCCCAGCC: CTAATACCCTCGGAGGCCCAGCCG
CTTCGGTCCGAGGCAGCAATGCTC: TTCGGTCCGAGGCAGCAATGCTCA
GATTCCACACTCCTACGATTATGC: ATTCCACACTCCTACGATTATGCC
GTACCCCATTCGCCTCTACCAAAA: TACCCCATTCGCCTCTACCAAAAT
ATAACTACAATGCTGGAAAGTCCT: TAACTACAATGCTGGAAAGTCCTT
AGCATAGCAAGGACTGTAGGCACG: GCATAGCAAGGACTGTAGGCACGA
AGGTATTATATGCTAACCTACTGC: GGTATTATATGCTAACCTACTGCT
CTTTTGCTGGTGTTTCTTGGATCG: TTTTGCTGGTGTTTCTTGGATCGT
AGACTAACACTGTTTTTTTGCGAG: GACTAACACTGTTTTTTTGCGAGT
CTTATTATTGCGTGGCATGCGTGA: TTATTATTGCGTGGCATGCGTGAC
TCGCGGAAGAACAGGATTAATCCA: CGCGGAAGAACAGGATTAATCCAT
ATCCGGATGAATCTCTGCAGAGTC: TCCGGATGAATCTCTGCAGAGTCA
GCACACAGACTTGCTGAGGACCCG: CACACAGACTTGCTGAGGACCCGA
GTCACTTCGGTCCGAGGCAGCAAT: TCACTTCGGTCCGAGGCAGCAATG
CAAACATACTAGTGATAACCGAGC: AAACATACTAGTGATAACCGAGCC
CAATGCTCACTCGGTAAGTAAGCG: AATGCTCACTCGGTAAGTAAGCGT
CACTTATTATTGCGTGGCATGCGT: ACTTATTATTGCGTGGCATGCGTG
TTATCTGAGCCATGACTTACAATG: TATCTGAGCCATGACTTACAATGC
CACACTACCAACAGGGCGAACATG: ACACTACCAACAGGGCGAACATGT
GCGCCACCGCCTCGTTGGCCTCTT: CGCCACCGCCTCGTTGGCCTCTTC
GCGTGAGCACGTATTCCTCTCATG: CGTGAGCACGTATTCCTCTCATGT
TGTCCCACATACTGACTTGCGCTT: GTCCCACATACTGACTTGCGCTTC
CAGGTGGATAAACTAAGCGGCTTA: AGGTGGATAAACTAAGCGGCTTAG
TATACTAGAGGGGCAAAGCACAGG: ATACTAGAGGGGCAAAGCACAGGC
GACGTTTCTCGCACGTGCTGCTTT: ACGTTTCTCGCACGTGCTGCTTTA
AGGAACCCGTATTTCAGTAGAAAT: GGAACCCGTATTTCAGTAGAAATA
CTGTCACGTAAAAGACCTCAATAT: TGTCACGTAAAAGACCTCAATATA
CAGATATTCCCGACTATTCGGTAC: AGATATTCCCGACTATTCGGTACA
GGGCAAATAACTACAATGCTGGAA: GGCAAATAACTACAATGCTGGAAA
CGGGCAATAGTGACAAAGGGTTGG: GGGCAATAGTGACAAAGGGTTGGG
GACTATAGAGGCCCGGCGTGAGCA: ACTATAGAGGCCCGGCGTGAGCAC
TGTTGACATCAAACGTTATGCGCT: GTTGACATCAAACGTTATGCGCTG
GTTTCTTGGATCGTGCGCCGACTT: TTTCTTGGATCGTGCGCCGACTTC
CCCCTTAGATCTAGCTGCAGTTGG: CCCTTAGATCTAGCTGCAGTTGGC
CGTTCCTGAATGCAGTTCCTAATC: GTTCCTGAATGCAGTTCCTAATCA
GTATTTCCTGTGGCCAAGTCCTCT: TATTTCCTGTGGCCAAGTCCTCTC
GGACAGAGTTTTAGCCGAATGTTT: GACAGAGTTTTAGCCGAATGTTTC
AATACCGGGCAATAGTGACAAAGG: ATACCGGGCAATAGTGACAAAGGG
AGTACGTTAACTTGGTAGGTGTAT: GTACGTTAACTTGGTAGGTGTATG
ACACGCTGAAAAAAATGCCAGGTG: CACGCTGAAAAAAATGCCAGGTGT
CAAGTCCTCTCTCGTCAGTTTGTG: AAGTCCTCTCTCGTCAGTTTGTGA
ATCGTTTTCGTAGCATGGAAAGAA: TCGTTTTCGTAGCATGGAAAGAAC
TAGAGGGGCAAAGCACAGGCCGAG: AGAGGGGCAAAGCACAGGCCGAGA
GGCGGTCACTGCACAATGATGGCG: GCGGTCACTGCACAATGATGGCGA
ACTTGGTAGGTGTATGAATCGTGT: CTTGGTAGGTGTATGAATCGTGTA
CGCGCCATGGAGCACACAGACTTG: GCGCCATGGAGCACACAGACTTGC
TAGGAACACACGAGTCCACGGTGC: AGGAACACACGAGTCCACGGTGCG
TAGTGTAAAAACTCCACAACCAAA: AGTGTAAAAACTCCACAACCAAAG
TACAGAATACCAGTACAGGTTCTG: ACAGAATACCAGTACAGGTTCTGC
CTCCCTCAGCCAGGTTGCGGCATA: TCCCTCAGCCAGGTTGCGGCATAG
CAGTAGAAATAGGAACACACGAGT: AGTAGAAATAGGAACACACGAGTC
TAGCACCAAAGCTCCGTACCCCAT: AGCACCAAAGCTCCGTACCCCATT
GTTATGCGCTGAATCGTTTTCGTA: TTATGCGCTGAATCGTTTTCGTAG
TTGTCCAATTCAATCGCTACTTTG: TGTCCAATTCAATCGCTACTTTGT
CTTATAGTATTACTGGTATACTCT: TTATAGTATTACTGGTATACTCTC
TTATCCGGCCCGTCAGCGTTCAGT: TATCCGGCCCGTCAGCGTTCAGTT
ATTTGCGCACGGTTAGAGGCATCT: TTTGCGCACGGTTAGAGGCATCTG
GAGTCCACGGTGCGCTAACGGTGA: AGTCCACGGTGCGCTAACGGTGAT
ACCCGTTCCAACCTGTCACGTAAA: CCCGTTCCAACCTGTCACGTAAAA
TAGAAATAGGAACACACGAGTCCA: AGAAATAGGAACACACGAGTCCAC
ACCTTGGTGCAGGACCTCAGTGTG: CCTTGGTGCAGGACCTCAGTGTGA
AATCGTTTTCGTAGCATGGAAAGA: ATCGTTTTCGTAGCATGGAAAGAA
AGTTGGCGCCCATGAGCACCGGTC: GTTGGCGCCCATGAGCACCGGTCC
GGACGTTTCTCGCACGTGCTGCTT: GACGTTTCTCGCACGTGCTGCTTT
TAACACTGTTTTTTTGCGAGTATC: AACACTGTTTTTTTGCGAGTATCA
GCTCAGGAACCCGTATTTCAGTAG: CTCAGGAACCCGTATTTCAGTAGA
AAATGCCAGGTGTAGAGAATCAGT: AATGCCAGGTGTAGAGAATCAGTT
CGGTCACTGCACAATGATGGCGAC: GGTCACTGCACAATGATGGCGACC
TGCGTAAATGGGTTAGGGAGGTGT: GCGTAAATGGGTTAGGGAGGTGTT
AAGTACGTTAACTTGGTAGGTGTA: AGTACGTTAACTTGGTAGGTGTAT
TCTTGAAGGGCAACGACGCGCCAT: CTTGAAGGGCAACGACGCGCCATG
CTCGTTGGCCTCTTCCACTAACAC: TCGTTGGCCTCTTCCACTAACACA
TGCCTGGCCACTTCTGAGCCCTCG: GCCTGGCCACTTCTGAGCCCTCGG
ATCGCTACTTTGTCCACGAATCTT: TCGCTACTTTGTCCACGAATCTTT
GCGCTTCTGCTATACAGGTGTCCC: CGCTTCTGCTATACAGGTGTCCCA
GTCCGAGTATTAGCACGTGGGAAA: TCCGAGTATTAGCACGTGGGAAAA
GAATGCAGTTCCTAATCAGACTGT: AATGCAGTTCCTAATCAGACTGTT
CTACTTTGTCCACGAATCTTTCCC: TACTTTGTCCACGAATCTTTCCCC
CGAACATGCCGATACGTCACATAC: GAACATGCCGATACGTCACATACA
AACCTGTCACGTAAAAGACCTCAA: ACCTGTCACGTAAAAGACCTCAAT
TTTGTGACGCCCGCTCAGGAACCC: TTGTGACGCCCGCTCAGGAACCCG
CTACAATGCTGGAAAGTCCTTTAT: TACAATGCTGGAAAGTCCTTTATT
ACTTGCTGAGGACCCGAGGAATCC: CTTGCTGAGGACCCGAGGAATCCG
CGCTTCTGCTATACAGGTGTCCCA: GCTTCTGCTATACAGGTGTCCCAC
GCGCCATGGAGCACACAGACTTGC: CGCCATGGAGCACACAGACTTGCT
GCCAGGTTGCGGCATAGATGGTTG: CCAGGTTGCGGCATAGATGGTTGG
ATACATGTGGATACGTCTCTAATA: TACATGTGGATACGTCTCTAATAC
AGAGTCAGTAGCCTCTATACAGTG: GAGTCAGTAGCCTCTATACAGTGA
GTTTTAGCCGAATGTTTCTCACTT: TTTTAGCCGAATGTTTCTCACTTG
ACTAGAGGGGCAAAGCACAGGCCG: CTAGAGGGGCAAAGCACAGGCCGA
CGGCGCCACCGCCTCGTTGGCCTC: GGCGCCACCGCCTCGTTGGCCTCT
TCCCCCGTGCGGCCGTCTGCGTGT: CCCCCGTGCGGCCGTCTGCGTGTC
TTTCCTGTGGCCAAGTCCTCTCTC: TTCCTGTGGCCAAGTCCTCTCTCG
TGTAGGCACGAGGGATATTGGTTG: GTAGGCACGAGGGATATTGGTTGT
ATACCCTCGGAGGCCCAGCCGTGT: TACCCTCGGAGGCCCAGCCGTGTG
CTAGCTGCAGTTGGCGCCCATGAG: TAGCTGCAGTTGGCGCCCATGAGC
GAGTCAGTAGCCTCTATACAGTGA: AGTCAGTAGCCTCTATACAGTGAT
ACCCGAGGAATCCGGATGAATCTC: CCCGAGGAATCCGGATGAATCTCT
TCGGAGGCCCAGCCGTGTGAAAAA: CGGAGGCCCAGCCGTGTGAAAAAA
AGGCACGAGGGATATTGGTTGTCC: GGCACGAGGGATATTGGTTGTCCT
ACTAGTGATAACCGAGCCCCAACA: CTAGTGATAACCGAGCCCCAACAG
GGTGACCCACGGTGTGTATGCATA: GTGACCCACGGTGTGTATGCATAA
GCGCTGAATCGTTTTCGTAGCATG: CGCTGAATCGTTTTCGTAGCATGG
GGCTAGTTGCACGCCACACTACCA: GCTAGTTGCACGCCACACTACCAA
CTGGCTTGGGCAAGGCAACATTAT: TGGCTTGGGCAAGGCAACATTATA
AACGGGCGGGTATTTCCTGTGGCC: ACGGGCGGGTATTTCCTGTGGCCA
CTGTTTTTTTGCGAGTATCAATGT: TGTTTTTTTGCGAGTATCAATGTT
ACTCCACAACCAAAGTCATTGTTA: CTCCACAACCAAAGTCATTGTTAG
GTGACGCCCGCTCAGGAACCCGTA: TGACGCCCGCTCAGGAACCCGTAT
ACTATTCGGTACAGAATACCAGTA: CTATTCGGTACAGAATACCAGTAC
AAGACCTCAATATAAACATTATGG: AGACCTCAATATAAACATTATGGA
ACATGTGGATACGTCTCTAATACC: CATGTGGATACGTCTCTAATACCC
AGACTCTTGAAGGGCAACGACGCG: GACTCTTGAAGGGCAACGACGCGC
TTATGCCTGGCCACTTCTGAGCCC: TATGCCTGGCCACTTCTGAGCCCT
TAACGGTGATGCATGGACAGAGTT: AACGGTGATGCATGGACAGAGTTT
CCATTCGCCTCTACCAAAATCCTT: CATTCGCCTCTACCAAAATCCTTC
GAACACTTAAACGGGCGGGTATTT: AACACTTAAACGGGCGGGTATTTC
CCCTCGGATCCCATAACATCAGAC: CCTCGGATCCCATAACATCAGACC
CCCTAGGTAAGGCGGTCACTGCAC: CCTAGGTAAGGCGGTCACTGCACA
GAAGAACAGGATTAATCCATTGGC: AAGAACAGGATTAATCCATTGGCG
CCAGGTGACCCACGGTGTGTATGC: CAGGTGACCCACGGTGTGTATGCA
ATGCTAACCTACTGCTGACATTCC: TGCTAACCTACTGCTGACATTCCC
CAACGACGCGCCATGGAGCACACA: AACGACGCGCCATGGAGCACACAG
CCTTCCACGGACAACCAGTTGTCT: CTTCCACGGACAACCAGTTGTCTC
GGTGTTTCTTGGATCGTGCGCCGA: GTGTTTCTTGGATCGTGCGCCGAC
TGCGTGACCTTGTAAGAGTTGGGA: GCGTGACCTTGTAAGAGTTGGGAC
GCCACCGCCTCGTTGGCCTCTTCC: CCACCGCCTCGTTGGCCTCTTCCA
GTGCAGGACCTCAGTGTGAGGTTA: TGCAGGACCTCAGTGTGAGGTTAA
GACCCGTTCCAACCTGTCACGTAA: ACCCGTTCCAACCTGTCACGTAAA
TCCTGTGGCCAAGTCCTCTCTCGT: CCTGTGGCCAAGTCCTCTCTCGTC
CGGAGGCCCAGCCGTGTGAAAAAA: GGAGGCCCAGCCGTGTGAAAAAAG
TTGCGAGTATCAATGTTGACATCA: TGCGAGTATCAATGTTGACATCAA
GGTTGGGCAAATAACTACAATGCT: GTTGGGCAAATAACTACAATGCTG
TTGCTGGTGTTTCTTGGATCGTGC: TGCTGGTGTTTCTTGGATCGTGCG
CTTGGGCAAGGCAACATTATACCT: TTGGGCAAGGCAACATTATACCTA
TCGTCCTTAACAAGTTAAGCGATT: CGTCCTTAACAAGTTAAGCGATTT
ACTTATCTGAGCCATGACTTACAA: CTTATCTGAGCCATGACTTACAAT
CTCTCGTCAGTTTGTGACGCCCGC: TCTCGTCAGTTTGTGACGCCCGCT
ATCCACAGGTTAGTGCACCATCAA: TCCACAGGTTAGTGCACCATCAAA
ACATACTAGTGATAACCGAGCCCC: CATACTAGTGATAACCGAGCCCCA
ATATTCCCGACTATTCGGTACAGA: TATTCCCGACTATTCGGTACAGAA
TAAAAGACCTCAATATAAACATTA: AAAAGACCTCAATATAAACATTAT
TGTCACTTCGGTCCGAGGCAGCAA: GTCACTTCGGTCCGAGGCAGCAAT
TTGTCTCAGGTAAATTGAGACTAT: TGTCTCAGGTAAATTGAGACTATA
GTCCTTTATTTGCGCACGGTTAGA: TCCTTTATTTGCGCACGGTTAGAG
CCTGAATGCAGTTCCTAATCAGAC: CTGAATGCAGTTCCTAATCAGACT
GTTCAGTTAGAAGAGACTAACACT: TTCAGTTAGAAGAGACTAACACTG
TCAGACTGGTCAGTGAAACGGAAC: CAGACTGGTCAGTGAAACGGAACA
ACTAAGCGGCTTAGACTCTTGAAG: CTAAGCGGCTTAGACTCTTGAAGG
GACATCAAACGTTATGCGCTGAAT: ACATCAAACGTTATGCGCTGAATC
ACTGCACAATGATGGCGACCCGTT: CTGCACAATGATGGCGACCCGTTC
CATGACTTACAATGCGAACCTTGC: ATGACTTACAATGCGAACCTTGCC
TGACATTCCCCCGTGCGGCCGTCT: GACATTCCCCCGTGCGGCCGTCTG
TTGGCGCCCATGAGCACCGGTCCC: TGGCGCCCATGAGCACCGGTCCCC
TTACTGGTATACTCTCCACTTATT: TACTGGTATACTCTCCACTTATTA
TAAGCGATTTTACTTATCTGAGCC: AAGCGATTTTACTTATCTGAGCCA
GGGCGAACATGTGTTTGTGTAGCT: GGCGAACATGTGTTTGTGTAGCTC
CCACGGTGCGCTAACGGTGATGCA: CACGGTGCGCTAACGGTGATGCAT
GAAGGGCAACGACGCGCCATGGAG: AAGGGCAACGACGCGCCATGGAGC
ATCGAGCTGTTCAACTTGGCAGCA: TCGAGCTGTTCAACTTGGCAGCAT
ACGATTATGCCTGGCCACTTCTGA: CGATTATGCCTGGCCACTTCTGAG
ATAGTGACAAAGGGTTGGGCAAAT: TAGTGACAAAGGGTTGGGCAAATA
TACGCAAGGACACAAGTGGGCGCT: ACGCAAGGACACAAGTGGGCGCTT
CGAGTATCAATGTTGACATCAAAC: GAGTATCAATGTTGACATCAAACG
GTCGGCGGGTTGTTAACTTAACAG: TCGGCGGGTTGTTAACTTAACAGA
TTGCGGCATAGATGGTTGGATGCA: TGCGGCATAGATGGTTGGATGCAG
AAAAAGTACGTTAACTTGGTAGGT: AAAAGTACGTTAACTTGGTAGGTG
AAGGACCCCTTAGATCTAGCTGCA: AGGACCCCTTAGATCTAGCTGCAG
TGCGTGGCATGCGTGACCTTGTAA: GCGTGGCATGCGTGACCTTGTAAG
TAGGGATTCCACACTCCTACGATT: AGGGATTCCACACTCCTACGATTA
CTCGTCAGTTTGTGACGCCCGCTC: TCGTCAGTTTGTGACGCCCGCTCA
GCAGAAGGACCCCTTAGATCTAGC: CAGAAGGACCCCTTAGATCTAGCT
AAGCGTGGCACTCTCGTCCTTAAC: AGCGTGGCACTCTCGTCCTTAACA
CATGTTTACTATACTAGAGGGGCA: ATGTTTACTATACTAGAGGGGCAA
GATATTCCCGACTATTCGGTACAG: ATATTCCCGACTATTCGGTACAGA
GCGAACCTTGCCATACATGTGGAT: CGAACCTTGCCATACATGTGGATA
TCCCATCGAGCTGTTCAACTTGGC: CCCATCGAGCTGTTCAACTTGGCA
CCGATACGTCACATACAAACATAC: CGATACGTCACATACAAACATACT
TCAAACGTTATGCGCTGAATCGTT: CAAACGTTATGCGCTGAATCGTTT
ATTATATGCTAACCTACTGCTGAC: TTATATGCTAACCTACTGCTGACA
TATACTCTCCACTTATTATTGCGT: ATACTCTCCACTTATTATTGCGTG
TGGGCAAATAACTACAATGCTGGA: GGGCAAATAACTACAATGCTGGAA
ACCGGGCAATAGTGACAAAGGGTT: CCGGGCAATAGTGACAAAGGGTTG
CTGGAAAGTCCTTTATTTGCGCAC: TGGAAAGTCCTTTATTTGCGCACG
GATGTTGGACGTTTCTCGCACGTG: ATGTTGGACGTTTCTCGCACGTGC
GCTGCAGTTGGCGCCCATGAGCAC: CTGCAGTTGGCGCCCATGAGCACC
CCGTACCCCATTCGCCTCTACCAA: CGTACCCCATTCGCCTCTACCAAA
TCACTTCGGTCCGAGGCAGCAATG: CACTTCGGTCCGAGGCAGCAATGC
TGTCACGTAAAAGACCTCAATATA: GTCACGTAAAAGACCTCAATATAA
TAATCCATTGGCGAGTTGAAACCG: AATCCATTGGCGAGTTGAAACCGT
GCCATGGAGCACACAGACTTGCTG: CCATGGAGCACACAGACTTGCTGA
GAGGCCCGGCGTGAGCACGTATTC: AGGCCCGGCGTGAGCACGTATTCC
GGCATGCGTGACCTTGTAAGAGTT: GCATGCGTGACCTTGTAAGAGTTG
GATTTACGCTTAGGTATTATATGC: ATTTACGCTTAGGTATTATATGCT
CGACTTCATCTACAATACGCAAGG: GACTTCATCTACAATACGCAAGGA
AGCTGACAATGTCACTTCGGTCCG: GCTGACAATGTCACTTCGGTCCGA
TGACATCAAACGTTATGCGCTGAA: GACATCAAACGTTATGCGCTGAAT
GTGAGCACGTATTCCTCTCATGTT: TGAGCACGTATTCCTCTCATGTTG
ACGAGGGATATTGGTTGTCCTACT: CGAGGGATATTGGTTGTCCTACTT
AGTTGAAACCGTCAGACTGGTCAG: GTTGAAACCGTCAGACTGGTCAGT
GGGTTAGGGAGGTGTTCTTATAGT: GGTTAGGGAGGTGTTCTTATAGTA
TGCTAACCTACTGCTGACATTCCC: GCTAACCTACTGCTGACATTCCCC
TGCGAACCTTGCCATACATGTGGA: GCGAACCTTGCCATACATGTGGAT
CAAAAGATAACACGCACATGTTTA: AAAAGATAACACGCACATGTTTAC
CAGGCCGAGAGGATCGTAGTGTAA: AGGCCGAGAGGATCGTAGTGTAAA
TTCACAAATAATTCATCGTGTCGT: TCACAAATAATTCATCGTGTCGTG
GATATTCCGCCAGATATTCCCGAC: ATATTCCGCCAGATATTCCCGACT
GGATCGTAGTGTAAAAACTCCACA: GATCGTAGTGTAAAAACTCCACAA
CTGTCACATAATGGATCCAACCAG: TGTCACATAATGGATCCAACCAGG
ATTCATCGTGTCGTGCGCCCCCTA: TTCATCGTGTCGTGCGCCCCCTAG
TCAGTGTGAGGTTAAGCTTTTGCT: CAGTGTGAGGTTAAGCTTTTGCTG
TAGTTGCACGCCACACTACCAACA: AGTTGCACGCCACACTACCAACAG
ACCGGCGAACATGCCGATACGTCA: CCGGCGAACATGCCGATACGTCAC
CCTTACTGGTGTCTCTCCGGCGCC: CTTACTGGTGTCTCTCCGGCGCCA
CTTAACAGACGCAGATACCGGCGA: TTAACAGACGCAGATACCGGCGAA
TATCCGGCCCGTCAGCGTTCAGTT: ATCCGGCCCGTCAGCGTTCAGTTA
ATAGGAACACACGAGTCCACGGTG: TAGGAACACACGAGTCCACGGTGC
ACTTCTGAGCCCTCGGATCCCATA: CTTCTGAGCCCTCGGATCCCATAA
ACCAGTTGTCTCAGGTAAATTGAG: CCAGTTGTCTCAGGTAAATTGAGA
CGGTGTGTATGCATAAGCGGTTTG: GGTGTGTATGCATAAGCGGTTTGC
GTTAGAAGAGACTAACACTGTTTT: TTAGAAGAGACTAACACTGTTTTT
CATAATGGATCCAACCAGGTGACC: ATAATGGATCCAACCAGGTGACCC
ACCGGCTAGTTGCACGCCACACTA: CCGGCTAGTTGCACGCCACACTAC
ATTATTGCGTGGCATGCGTGACCT: TTATTGCGTGGCATGCGTGACCTT
TGATGTAAGCACATTGTACGATGT: GATGTAAGCACATTGTACGATGTT
CTCCACAACCAAAGTCATTGTTAG: TCCACAACCAAAGTCATTGTTAGG
GCCTCTTCCACTAACACACCTTGG: CCTCTTCCACTAACACACCTTGGT
AGCTGTTCAACTTGGCAGCATAGC: GCTGTTCAACTTGGCAGCATAGCA
TGATGGCGACCCGTTCCAACCTGT: GATGGCGACCCGTTCCAACCTGTC
CCCCAACAGGTGGATAAACTAAGC: CCCAACAGGTGGATAAACTAAGCG
CACCAAAGCTCCGTACCCCATTCG: ACCAAAGCTCCGTACCCCATTCGC
TTGGCCTCTTCCACTAACACACCT: TGGCCTCTTCCACTAACACACCTT
TAATGGATCCAACCAGGTGACCCA: AATGGATCCAACCAGGTGACCCAC
ATGTTGACATCAAACGTTATGCGC: TGTTGACATCAAACGTTATGCGCT
CCTGTGGCCAAGTCCTCTCTCGTC: CTGTGGCCAAGTCCTCTCTCGTCA
CATCGTGTCGTGCGCCCCCTAGGT: ATCGTGTCGTGCGCCCCCTAGGTA
ACATTGTACGATGTTGGACGTTTC: CATTGTACGATGTTGGACGTTTCT
CAGTTCCTAATCAGACTGTTTAGG: AGTTCCTAATCAGACTGTTTAGGG
GCGTGACCTTGTAAGAGTTGGGAC: CGTGACCTTGTAAGAGTTGGGACG
AAAAGTACGTTAACTTGGTAGGTG: AAAGTACGTTAACTTGGTAGGTGT
ATCAAACGTTATGCGCTGAATCGT: TCAAACGTTATGCGCTGAATCGTT
GGTAGGTGTATGAATCGTGTAACA: GTAGGTGTATGAATCGTGTAACAC
GGCCGTCTGCGTGTCCAAAAGTTG: GCCGTCTGCGTGTCCAAAAGTTGT
TCTCTCCGGCGCCACCGCCTCGTT: CTCTCCGGCGCCACCGCCTCGTTG
GAGGAATCCGGATGAATCTCTGCA: AGGAATCCGGATGAATCTCTGCAG
GTACGATGTTGGACGTTTCTCGCA: TACGATGTTGGACGTTTCTCGCAC
ACCTGTTTCCGATAAGGTGCACCT: CCTGTTTCCGATAAGGTGCACCTA
TTAAACGGGCGGGTATTTCCTGTG: TAAACGGGCGGGTATTTCCTGTGG
TCAGAGTCCGAGTATTAGCACGTG: CAGAGTCCGAGTATTAGCACGTGG
AAGCGGCTTAGACTCTTGAAGGGC: AGCGGCTTAGACTCTTGAAGGGCA
TAACACGCACATGTTTACTATACT: AACACGCACATGTTTACTATACTA
ATACGTCACATACAAACATACTAG: TACGTCACATACAAACATACTAGT
CAAGGCAACATTATACCTAAGCTT: AAGGCAACATTATACCTAAGCTTC
ACATGTTTACTATACTAGAGGGGC: CATGTTTACTATACTAGAGGGGCA
GGCCCGTCAGCGTTCAGTTAGAAG: GCCCGTCAGCGTTCAGTTAGAAGA
CACACCTTGGTGCAGGACCTCAGT: ACACCTTGGTGCAGGACCTCAGTG
CTGACTTGCGCTTCGCGGAAGAAC: TGACTTGCGCTTCGCGGAAGAACA
AGGACCTCAGTGTGAGGTTAAGCT: GGACCTCAGTGTGAGGTTAAGCTT
GCCTGGCCACTTCTGAGCCCTCGG: CCTGGCCACTTCTGAGCCCTCGGA
GGAAGAACAGGATTAATCCATTGG: GAAGAACAGGATTAATCCATTGGC
TAATTCATCGTGTCGTGCGCCCCC: AATTCATCGTGTCGTGCGCCCCCT
TTCGGTCCGAGGCAGCAATGCTCA: TCGGTCCGAGGCAGCAATGCTCAC
ACGCTGAAAAAAATGCCAGGTGTA: CGCTGAAAAAAATGCCAGGTGTAG
TGTGTATGCATAAGCGGTTTGCTG: GTGTATGCATAAGCGGTTTGCTGG
CCCCGTACTGTCACATAATGGATC: CCCGTACTGTCACATAATGGATCC
GTTGTGCGTAAATGGGTTAGGGAG: TTGTGCGTAAATGGGTTAGGGAGG
GAAACCGTCAGACTGGTCAGTGAA: AAACCGTCAGACTGGTCAGTGAAA
AGCTCCGTACCCCATTCGCCTCTA: GCTCCGTACCCCATTCGCCTCTAC
CGAGGAATCCGGATGAATCTCTGC: GAGGAATCCGGATGAATCTCTGCA
GTAAGCACATTGTACGATGTTGGA: TAAGCACATTGTACGATGTTGGAC
TAAGCGGTTTGCTGGCTTGGGCAA: AAGCGGTTTGCTGGCTTGGGCAAG
GGAGGCCCAGCCGTGTGAAAAAAG: GAGGCCCAGCCGTGTGAAAAAAGT
GGACTGTAGGCACGAGGGATATTG: GACTGTAGGCACGAGGGATATTGG
ACTGGTCAGTGAAACGGAACACTT: CTGGTCAGTGAAACGGAACACTTA
TTTAGGGCTTCGACGCGCCTTACT: TTAGGGCTTCGACGCGCCTTACTG
GCCTTACTGGTGTCTCTCCGGCGC: CCTTACTGGTGTCTCTCCGGCGCC
CGAATGTTTCTCACTTGATCCACA: GAATGTTTCTCACTTGATCCACAG
AGACTATAGAGGCCCGGCGTGAGC: GACTATAGAGGCCCGGCGTGAGCA
ATGCATGGACAGAGTTTTAGCCGA: TGCATGGACAGAGTTTTAGCCGAA
TTGTTAGGGATTCCACACTCCTAC: TGTTAGGGATTCCACACTCCTACG
TCGACGCGCCTTACTGGTGTCTCT: CGACGCGCCTTACTGGTGTCTCTC
ATGTAAGCACATTGTACGATGTTG: TGTAAGCACATTGTACGATGTTGG
GCGTGGCATGCGTGACCTTGTAAG: CGTGGCATGCGTGACCTTGTAAGA
AGGGTTGGGCAAATAACTACAATG: GGGTTGGGCAAATAACTACAATGC
CTACCAACAGGGCGAACATGTGTT: TACCAACAGGGCGAACATGTGTTT
TTCTTATAGTATTACTGGTATACT: TCTTATAGTATTACTGGTATACTC
AGCACAGGCCGAGAGGATCGTAGT: GCACAGGCCGAGAGGATCGTAGTG
AGAGGCATCTGCGTTCCTGAATGC: GAGGCATCTGCGTTCCTGAATGCA
CCTACTGCTGACATTCCCCCGTGC: CTACTGCTGACATTCCCCCGTGCG
AACGTTATGCGCTGAATCGTTTTC: ACGTTATGCGCTGAATCGTTTTCG
GCCCGTCAGCGTTCAGTTAGAAGA: CCCGTCAGCGTTCAGTTAGAAGAG
CCTTTATTTGCGCACGGTTAGAGG: CTTTATTTGCGCACGGTTAGAGGC
CCAGGTGTAGAGAATCAGTTGAAC: CAGGTGTAGAGAATCAGTTGAACG
GTATTACTGGTATACTCTCCACTT: TATTACTGGTATACTCTCCACTTA
GAAATAGGAACACACGAGTCCACG: AAATAGGAACACACGAGTCCACGG
TCGTTTTCGTAGCATGGAAAGAAC: CGTTTTCGTAGCATGGAAAGAACC
GTCAGACTGGTCAGTGAAACGGAA: TCAGACTGGTCAGTGAAACGGAAC
CGTTCAGTTAGAAGAGACTAACAC: GTTCAGTTAGAAGAGACTAACACT
TATGCGCTGAATCGTTTTCGTAGC: ATGCGCTGAATCGTTTTCGTAGCA
GTTGACATCAAACGTTATGCGCTG: TTGACATCAAACGTTATGCGCTGA
TGGGCAAGGCAACATTATACCTAA: GGGCAAGGCAACATTATACCTAAG
ATTATACCTAAGCTTCAGAGTCCG: TTATACCTAAGCTTCAGAGTCCGA
AAGCGATTTTACTTATCTGAGCCA: AGCGATTTTACTTATCTGAGCCAT
CCTTAGATCTAGCTGCAGTTGGCG: CTTAGATCTAGCTGCAGTTGGCGC
AGTGATTTACGCTTAGGTATTATA: GTGATTTACGCTTAGGTATTATAT
CGGCGAACATGCCGATACGTCACA: GGCGAACATGCCGATACGTCACAT
TCCGATAAGGTGCACCTAACCTTT: CCGATAAGGTGCACCTAACCTTTT
CACGCACATGTTTACTATACTAGA: ACGCACATGTTTACTATACTAGAG
AAATAACTACAATGCTGGAAAGTC: AATAACTACAATGCTGGAAAGTCC
GCCATGACTTACAATGCGAACCTT: CCATGACTTACAATGCGAACCTTG
AGGACTGTAGGCACGAGGGATATT: GGACTGTAGGCACGAGGGATATTG
CTTCTGAGCCCTCGGATCCCATAA: TTCTGAGCCCTCGGATCCCATAAC
CCCACATACTGACTTGCGCTTCGC: CCACATACTGACTTGCGCTTCGCG
TATTGCGTGGCATGCGTGACCTTG: ATTGCGTGGCATGCGTGACCTTGT
CATGTGGATACGTCTCTAATACCC: ATGTGGATACGTCTCTAATACCCT
CACTCGGTAAGTAAGCGTGGCACT: ACTCGGTAAGTAAGCGTGGCACTC
CCACGAATCTTTCCCCTCCCTCAG: CACGAATCTTTCCCCTCCCTCAGC
AGCAAGGACTGTAGGCACGAGGGA: GCAAGGACTGTAGGCACGAGGGAT
CCGACTTCATCTACAATACGCAAG: CGACTTCATCTACAATACGCAAGG
GTGTCCCACATACTGACTTGCGCT: TGTCCCACATACTGACTTGCGCTT
CGAGAGGATCGTAGTGTAAAAACT: GAGAGGATCGTAGTGTAAAAACTC
ATCGTGTAACACGCTGAAAAAAAT: TCGTGTAACACGCTGAAAAAAATG
GTGACAAAGGGTTGGGCAAATAAC: TGACAAAGGGTTGGGCAAATAACT
GCCACTTCTGAGCCCTCGGATCCC: CCACTTCTGAGCCCTCGGATCCCA
ATGGAGCACACAGACTTGCTGAGG: TGGAGCACACAGACTTGCTGAGGA
AACATCAGACCTGTTTCCGATAAG: ACATCAGACCTGTTTCCGATAAGG
ATGCAGAAGGACCCCTTAGATCTA: TGCAGAAGGACCCCTTAGATCTAG
GTAAGCGTGGCACTCTCGTCCTTA: TAAGCGTGGCACTCTCGTCCTTAA
AGGTTCTGCAGAAGTATAGCTGAC: GGTTCTGCAGAAGTATAGCTGACA
AAAGTACGTTAACTTGGTAGGTGT: AAGTACGTTAACTTGGTAGGTGTA
CATTGTACGATGTTGGACGTTTCT: ATTGTACGATGTTGGACGTTTCTC
TTACTTATCTGAGCCATGACTTAC: TACTTATCTGAGCCATGACTTACA
GGCCAAGTCCTCTCTCGTCAGTTT: GCCAAGTCCTCTCTCGTCAGTTTG
CTGTTCAACTTGGCAGCATAGCAA: TGTTCAACTTGGCAGCATAGCAAG
AAGAACAGGATTAATCCATTGGCG: AGAACAGGATTAATCCATTGGCGA
CATGGAGCACACAGACTTGCTGAG: ATGGAGCACACAGACTTGCTGAGG
TCAGACCTGTTTCCGATAAGGTGC: CAGACCTGTTTCCGATAAGGTGCA
AGGTGTTCTTATAGTATTACTGGT: GGTGTTCTTATAGTATTACTGGTA
AGATAACACGCACATGTTTACTAT: GATAACACGCACATGTTTACTATA
CCTTGGTGCAGGACCTCAGTGTGA: CTTGGTGCAGGACCTCAGTGTGAG
AATCCATTGGCGAGTTGAAACCGT: ATCCATTGGCGAGTTGAAACCGTC
GGATCCCATAACATCAGACCTGTT: GATCCCATAACATCAGACCTGTTT
CGTCTGCGTGTCCAAAAGTTGTGC: GTCTGCGTGTCCAAAAGTTGTGCG
TGAGCACGTATTCCTCTCATGTTG: GAGCACGTATTCCTCTCATGTTGC
CTGCTGACATTCCCCCGTGCGGCC: TGCTGACATTCCCCCGTGCGGCCG
GTTTCTCGCACGTGCTGCTTTATC: TTTCTCGCACGTGCTGCTTTATCC
AAGCTTCAGAGTCCGAGTATTAGC: AGCTTCAGAGTCCGAGTATTAGCA
GAGCACACAGACTTGCTGAGGACC: AGCACACAGACTTGCTGAGGACCC
GTATGCATAAGCGGTTTGCTGGCT: TATGCATAAGCGGTTTGCTGGCTT
TTGCACGTTTGTCCAATTCAATCG: TGCACGTTTGTCCAATTCAATCGC
TTGGCGAGTTGAAACCGTCAGACT: TGGCGAGTTGAAACCGTCAGACTG
CTTCAGAGTCCGAGTATTAGCACG: TTCAGAGTCCGAGTATTAGCACGT
CACTTCTGAGCCCTCGGATCCCAT: ACTTCTGAGCCCTCGGATCCCATA
TGTTGCACGTTTGTCCAATTCAAT: GTTGCACGTTTGTCCAATTCAATC
GTTTAGGGCTTCGACGCGCCTTAC: TTTAGGGCTTCGACGCGCCTTACT
GCCAGGTGTAGAGAATCAGTTGAA: CCAGGTGTAGAGAATCAGTTGAAC
CATGCGTGACCTTGTAAGAGTTGG: ATGCGTGACCTTGTAAGAGTTGGG
CACTTAAACGGGCGGGTATTTCCT: ACTTAAACGGGCGGGTATTTCCTG
TGTGAAAAAAGTACGTTAACTTGG: GTGAAAAAAGTACGTTAACTTGGT
CCGAGCCCCAACAGGTGGATAAAC: CGAGCCCCAACAGGTGGATAAACT
AACTTGGTAGGTGTATGAATCGTG: ACTTGGTAGGTGTATGAATCGTGT
TTAGGGATTCCACACTCCTACGAT: TAGGGATTCCACACTCCTACGATT
CTTTGTCCACGAATCTTTCCCCTC: TTTGTCCACGAATCTTTCCCCTCC
AAAATCCTTCCACGGACAACCAGT: AAATCCTTCCACGGACAACCAGTT
CAGTTAGAAGAGACTAACACTGTT: AGTTAGAAGAGACTAACACTGTTT
AAATACCGGGCAATAGTGACAAAG: AATACCGGGCAATAGTGACAAAGG
ACGCCACACTACCAACAGGGCGAA: CGCCACACTACCAACAGGGCGAAC
GAACCCGTATTTCAGTAGAAATAG: AACCCGTATTTCAGTAGAAATAGG
GTTGCACGCCACACTACCAACAGG: TTGCACGCCACACTACCAACAGGG
ATCAATGTTGACATCAAACGTTAT: TCAATGTTGACATCAAACGTTATG
GCACGGTTAGAGGCATCTGCGTTC: CACGGTTAGAGGCATCTGCGTTCC
TCCACGAATCTTTCCCCTCCCTCA: CCACGAATCTTTCCCCTCCCTCAG
AGTGGGCGCTTCTGCTATACAGGT: GTGGGCGCTTCTGCTATACAGGTG
CTGGCCACTTCTGAGCCCTCGGAT: TGGCCACTTCTGAGCCCTCGGATC
AGGTTGCGGCATAGATGGTTGGAT: GGTTGCGGCATAGATGGTTGGATG
ACAGGTGGATAAACTAAGCGGCTT: CAGGTGGATAAACTAAGCGGCTTA
AATGATGGCGACCCGTTCCAACCT: ATGATGGCGACCCGTTCCAACCTG
ACAGGGCGAACATGTGTTTGTGTA: CAGGGCGAACATGTGTTTGTGTAG
CAATATAAACATTATGGATATTCC: AATATAAACATTATGGATATTCCG
TATTCCGCCAGATATTCCCGACTA: ATTCCGCCAGATATTCCCGACTAT
CATTATGGATATTCCGCCAGATAT: ATTATGGATATTCCGCCAGATATT
GCACCTAACCTTTTCACAAATAAT: CACCTAACCTTTTCACAAATAATT
CATCGAGCTGTTCAACTTGGCAGC: ATCGAGCTGTTCAACTTGGCAGCA
TAGGTATTATATGCTAACCTACTG: AGGTATTATATGCTAACCTACTGC
CGTCAGCGTTCAGTTAGAAGAGAC: GTCAGCGTTCAGTTAGAAGAGACT
GGTAAGGCGGTCACTGCACAATGA: GTAAGGCGGTCACTGCACAATGAT
ACGCAAGGACACAAGTGGGCGCTT: CGCAAGGACACAAGTGGGCGCTTC
ACAACCAGTTGTCTCAGGTAAATT: CAACCAGTTGTCTCAGGTAAATTG
GGCATAGATGGTTGGATGCAGAAG: GCATAGATGGTTGGATGCAGAAGG
CCTCAGTGTGAGGTTAAGCTTTTG: CTCAGTGTGAGGTTAAGCTTTTGC
TGTAACACGCTGAAAAAAATGCCA: GTAACACGCTGAAAAAAATGCCAG
GACTTACAATGCGAACCTTGCCAT: ACTTACAATGCGAACCTTGCCATA
CACAAGTGGGCGCTTCTGCTATAC: ACAAGTGGGCGCTTCTGCTATACA
GCGTGGCACTCTCGTCCTTAACAA: CGTGGCACTCTCGTCCTTAACAAG
GTCACTGCACAATGATGGCGACCC: TCACTGCACAATGATGGCGACCCG
ACGAATCTTTCCCCTCCCTCAGCC: CGAATCTTTCCCCTCCCTCAGCCA
TATTGGTTGTCCTACTTCACCGGC: ATTGGTTGTCCTACTTCACCGGCT
CACAACCAAAGTCATTGTTAGGGA: ACAACCAAAGTCATTGTTAGGGAT
AGTCCGAGTATTAGCACGTGGGAA: GTCCGAGTATTAGCACGTGGGAAA
TGTTTCTCACTTGATCCACAGGTT: GTTTCTCACTTGATCCACAGGTTA
CCGTGCGGCCGTCTGCGTGTCCAA: CGTGCGGCCGTCTGCGTGTCCAAA
CTTAGATCTAGCTGCAGTTGGCGC: TTAGATCTAGCTGCAGTTGGCGCC
AAGAGACTAACACTGTTTTTTTGC: AGAGACTAACACTGTTTTTTTGCG
TGAGCCCTCGGATCCCATAACATC: GAGCCCTCGGATCCCATAACATCA
TGTTTTTTTGCGAGTATCAATGTT: GTTTTTTTGCGAGTATCAATGTTG
CCATGACTTACAATGCGAACCTTG: CATGACTTACAATGCGAACCTTGC
GGCGAACATGCCGATACGTCACAT: GCGAACATGCCGATACGTCACATA
GCACCAAAGCTCCGTACCCCATTC: CACCAAAGCTCCGTACCCCATTCG
CAGTGATTTACGCTTAGGTATTAT: AGTGATTTACGCTTAGGTATTATA
ACGCAGATACCGGCGAACATGCCG: CGCAGATACCGGCGAACATGCCGA
AACGTTGATGTAAGCACATTGTAC: ACGTTGATGTAAGCACATTGTACG
GCTAGTTGCACGCCACACTACCAA: CTAGTTGCACGCCACACTACCAAC
CCGCCTCGTTGGCCTCTTCCACTA: CGCCTCGTTGGCCTCTTCCACTAA
GTTTTCGTAGCATGGAAAGAACCT: TTTTCGTAGCATGGAAAGAACCTT
GCCGAGAGGATCGTAGTGTAAAAA: CCGAGAGGATCGTAGTGTAAAAAC
TATTTCAGTAGAAATAGGAACACA: ATTTCAGTAGAAATAGGAACACAC
GGCCACTTCTGAGCCCTCGGATCC: GCCACTTCTGAGCCCTCGGATCCC
AGTCCTCTCTCGTCAGTTTGTGAC: GTCCTCTCTCGTCAGTTTGTGACG
GCATGCGTGACCTTGTAAGAGTTG: CATGCGTGACCTTGTAAGAGTTGG
ACGGACAACCAGTTGTCTCAGGTA: CGGACAACCAGTTGTCTCAGGTAA
CGGATCCCATAACATCAGACCTGT: GGATCCCATAACATCAGACCTGTT
TGCTGAGGACCCGAGGAATCCGGA: GCTGAGGACCCGAGGAATCCGGAT
GTGCTGCTTTATCCGGCCCGTCAG: TGCTGCTTTATCCGGCCCGTCAGC
AATCAGTTGAACGTTGATGTAAGC: ATCAGTTGAACGTTGATGTAAGCA
TGATGCATGGACAGAGTTTTAGCC: GATGCATGGACAGAGTTTTAGCCG
ATAAGGTGCACCTAACCTTTTCAC: TAAGGTGCACCTAACCTTTTCACA
TTGCGCACGGTTAGAGGCATCTGC: TGCGCACGGTTAGAGGCATCTGCG
GCTGAAAAAAATGCCAGGTGTAGA: CTGAAAAAAATGCCAGGTGTAGAG
ACTTCACCGGCTAGTTGCACGCCA: CTTCACCGGCTAGTTGCACGCCAC
ACGAGTCCACGGTGCGCTAACGGT: CGAGTCCACGGTGCGCTAACGGTG
TTCTGAGCCCTCGGATCCCATAAC: TCTGAGCCCTCGGATCCCATAACA
GCCGTGTGAAAAAAGTACGTTAAC: CCGTGTGAAAAAAGTACGTTAACT
GTTGGCCTCTTCCACTAACACACC: TTGGCCTCTTCCACTAACACACCT
AGCGTTCAGTTAGAAGAGACTAAC: GCGTTCAGTTAGAAGAGACTAACA
TTCAGTAGAAATAGGAACACACGA: TCAGTAGAAATAGGAACACACGAG
CACTGTTTTTTTGCGAGTATCAAT: ACTGTTTTTTTGCGAGTATCAATG
ACTACCAACAGGGCGAACATGTGT: CTACCAACAGGGCGAACATGTGTT
ACTCTCGTCCTTAACAAGTTAAGC: CTCTCGTCCTTAACAAGTTAAGCG
GTTGTCCTACTTCACCGGCTAGTT: TTGTCCTACTTCACCGGCTAGTTG
GGCGGGTTGTTAACTTAACAGACG: GCGGGTTGTTAACTTAACAGACGC
CAGTTGTCTCAGGTAAATTGAGAC: AGTTGTCTCAGGTAAATTGAGACT
TACCAGTACAGGTTCTGCAGAAGT: ACCAGTACAGGTTCTGCAGAAGTA
ACTTAAACGGGCGGGTATTTCCTG: CTTAAACGGGCGGGTATTTCCTGT
CTCCACTTATTATTGCGTGGCATG: TCCACTTATTATTGCGTGGCATGC
GTTCCTAATCAGACTGTTTAGGGC: TTCCTAATCAGACTGTTTAGGGCT
AACACTGTTTTTTTGCGAGTATCA: ACACTGTTTTTTTGCGAGTATCAA
ATTTCCTGTGGCCAAGTCCTCTCT: TTTCCTGTGGCCAAGTCCTCTCTC
CGGACAACCAGTTGTCTCAGGTAA: GGACAACCAGTTGTCTCAGGTAAA
AATCCTTCCACGGACAACCAGTTG: ATCCTTCCACGGACAACCAGTTGT
GCTGCTTTATCCGGCCCGTCAGCG: CTGCTTTATCCGGCCCGTCAGCGT
GTCCTCTCTCGTCAGTTTGTGACG: TCCTCTCTCGTCAGTTTGTGACGC
TGAATCTCTGCAGAGTCAGTAGCC: GAATCTCTGCAGAGTCAGTAGCCT
TACCCCATTCGCCTCTACCAAAAT: ACCCCATTCGCCTCTACCAAAATC
TCCGGATGAATCTCTGCAGAGTCA: CCGGATGAATCTCTGCAGAGTCAG
ATTGGCGAGTTGAAACCGTCAGAC: TTGGCGAGTTGAAACCGTCAGACT
TCTCGTCCTTAACAAGTTAAGCGA: CTCGTCCTTAACAAGTTAAGCGAT
CGTCTCTAATACCCTCGGAGGCCC: GTCTCTAATACCCTCGGAGGCCCA
CAACAGGGCGAACATGTGTTTGTG: AACAGGGCGAACATGTGTTTGTGT
CCAGCCGTGTGAAAAAAGTACGTT: CAGCCGTGTGAAAAAAGTACGTTA
TCCAATTCAATCGCTACTTTGTCC: CCAATTCAATCGCTACTTTGTCCA
TGGCAGCATAGCAAGGACTGTAGG: GGCAGCATAGCAAGGACTGTAGGC
CAGACCTGTTTCCGATAAGGTGCA: AGACCTGTTTCCGATAAGGTGCAC
GCCGTCTGCGTGTCCAAAAGTTGT: CCGTCTGCGTGTCCAAAAGTTGTG
GGTCACTGCACAATGATGGCGACC: GTCACTGCACAATGATGGCGACCC
CGACGCGCCATGGAGCACACAGAC: GACGCGCCATGGAGCACACAGACT
GGACGAATCTAGCACCAAAGCTCC: GACGAATCTAGCACCAAAGCTCCG
CGTCGGCGGGTTGTTAACTTAACA: GTCGGCGGGTTGTTAACTTAACAG
GCCCAGCCGTGTGAAAAAAGTACG: CCCAGCCGTGTGAAAAAAGTACGT
TGCTGGTGTTTCTTGGATCGTGCG: GCTGGTGTTTCTTGGATCGTGCGC
GGGAAAATACCGGGCAATAGTGAC: GGAAAATACCGGGCAATAGTGACA
GGTGTAGAGAATCAGTTGAACGTT: GTGTAGAGAATCAGTTGAACGTTG
TAGAGAATCAGTTGAACGTTGATG: AGAGAATCAGTTGAACGTTGATGT
CATGGAAAGAACCTTTTCCCATCG: ATGGAAAGAACCTTTTCCCATCGA
TCACTCGGTAAGTAAGCGTGGCAC: CACTCGGTAAGTAAGCGTGGCACT
GCTTAGGTATTATATGCTAACCTA: CTTAGGTATTATATGCTAACCTAC
AAGGGTTGGGCAAATAACTACAAT: AGGGTTGGGCAAATAACTACAATG
CTTGGCAGCATAGCAAGGACTGTA: TTGGCAGCATAGCAAGGACTGTAG
TGGATCGTGCGCCGACTTCATCTA: GGATCGTGCGCCGACTTCATCTAC
CTCTTGAAGGGCAACGACGCGCCA: TCTTGAAGGGCAACGACGCGCCAT
CTTGCCATACATGTGGATACGTCT: TTGCCATACATGTGGATACGTCTC
GCACGCCACACTACCAACAGGGCG: CACGCCACACTACCAACAGGGCGA
AGTCATTGTTAGGGATTCCACACT: GTCATTGTTAGGGATTCCACACTC
AAGTATAGCTGACAATGTCACTTC: AGTATAGCTGACAATGTCACTTCG
TAGGCACGAGGGATATTGGTTGTC: AGGCACGAGGGATATTGGTTGTCC
ATCAGACCTGTTTCCGATAAGGTG: TCAGACCTGTTTCCGATAAGGTGC
CGAATCTAGCACCAAAGCTCCGTA: GAATCTAGCACCAAAGCTCCGTAC
AGATCTAGCTGCAGTTGGCGCCCA: GATCTAGCTGCAGTTGGCGCCCAT
GTTGGACGTTTCTCGCACGTGCTG: TTGGACGTTTCTCGCACGTGCTGC
CGTGTCCAAAAGTTGTGCGTAAAT: GTGTCCAAAAGTTGTGCGTAAATG
GCTAACCTACTGCTGACATTCCCC: CTAACCTACTGCTGACATTCCCCC
CTGAGGACCCGAGGAATCCGGATG: TGAGGACCCGAGGAATCCGGATGA
GCGTAAATGGGTTAGGGAGGTGTT: CGTAAATGGGTTAGGGAGGTGTTC
ATGTTTCTCACTTGATCCACAGGT: TGTTTCTCACTTGATCCACAGGTT
TCATTGTTAGGGATTCCACACTCC: CATTGTTAGGGATTCCACACTCCT
GACGCAGATACCGGCGAACATGCC: ACGCAGATACCGGCGAACATGCCG
GAACATGCCGATACGTCACATACA: AACATGCCGATACGTCACATACAA
TGCTGGAAAGTCCTTTATTTGCGC: GCTGGAAAGTCCTTTATTTGCGCA
ACAGGTTCTGCAGAAGTATAGCTG: CAGGTTCTGCAGAAGTATAGCTGA
AAAAGTTGTGCGTAAATGGGTTAG: AAAGTTGTGCGTAAATGGGTTAGG
GCTATACAGGTGTCCCACATACTG: CTATACAGGTGTCCCACATACTGA
GCGAACATGTGTTTGTGTAGCTCA: CGAACATGTGTTTGTGTAGCTCAG
TAACCGTCGGCGGGTTGTTAACTT: AACCGTCGGCGGGTTGTTAACTTA
CGAGTATTAGCACGTGGGAAAATA: GAGTATTAGCACGTGGGAAAATAC
CTGGTATACTCTCCACTTATTATT: TGGTATACTCTCCACTTATTATTG
ACTCGGTAAGTAAGCGTGGCACTC: CTCGGTAAGTAAGCGTGGCACTCT
AACCAAAGTCATTGTTAGGGATTC: ACCAAAGTCATTGTTAGGGATTCC
CCAAAATCCTTCCACGGACAACCA: CAAAATCCTTCCACGGACAACCAG
CCACTTCTGAGCCCTCGGATCCCA: CACTTCTGAGCCCTCGGATCCCAT
TTTTGCTGGTGTTTCTTGGATCGT: TTTGCTGGTGTTTCTTGGATCGTG
TAGATGGTTGGATGCAGAAGGACC: AGATGGTTGGATGCAGAAGGACCC
TTAGGGCTTCGACGCGCCTTACTG: TAGGGCTTCGACGCGCCTTACTGG
ATGTTGGACGTTTCTCGCACGTGC: TGTTGGACGTTTCTCGCACGTGCT
TCAGTAGCCTCTATACAGTGATTT: CAGTAGCCTCTATACAGTGATTTA
ATGGTTGGATGCAGAAGGACCCCT: TGGTTGGATGCAGAAGGACCCCTT
CGTGTCGTGCGCCCCCTAGGTAAG: GTGTCGTGCGCCCCCTAGGTAAGG
CGATTATGCCTGGCCACTTCTGAG: GATTATGCCTGGCCACTTCTGAGC
AACCCGTATTTCAGTAGAAATAGG: ACCCGTATTTCAGTAGAAATAGGA
CTACCAAAATCCTTCCACGGACAA: TACCAAAATCCTTCCACGGACAAC
GTTTACTATACTAGAGGGGCAAAG: TTTACTATACTAGAGGGGCAAAGC
TGTAAAAACTCCACAACCAAAGTC: GTAAAAACTCCACAACCAAAGTCA
GACGCGCCTTACTGGTGTCTCTCC: ACGCGCCTTACTGGTGTCTCTCCG
CTAGTTGCACGCCACACTACCAAC: TAGTTGCACGCCACACTACCAACA
GATAAGGTGCACCTAACCTTTTCA: ATAAGGTGCACCTAACCTTTTCAC
AGGTAAGGCGGTCACTGCACAATG: GGTAAGGCGGTCACTGCACAATGA
GCCCCAACAGGTGGATAAACTAAG: CCCCAACAGGTGGATAAACTAAGC
ACTCCTACGATTATGCCTGGCCAC: CTCCTACGATTATGCCTGGCCACT
CGGTGCGCTAACGGTGATGCATGG: GGTGCGCTAACGGTGATGCATGGA
AACCGTCGGCGGGTTGTTAACTTA: ACCGTCGGCGGGTTGTTAACTTAA
GCTGGAAAGTCCTTTATTTGCGCA: CTGGAAAGTCCTTTATTTGCGCAC
GATGAATCTCTGCAGAGTCAGTAG: ATGAATCTCTGCAGAGTCAGTAGC
TGCATGGACAGAGTTTTAGCCGAA: GCATGGACAGAGTTTTAGCCGAAT
CGCCACCGCCTCGTTGGCCTCTTC: GCCACCGCCTCGTTGGCCTCTTCC
TCCGAGTATTAGCACGTGGGAAAA: CCGAGTATTAGCACGTGGGAAAAT
ATTATGGATATTCCGCCAGATATT: TTATGGATATTCCGCCAGATATTC
GCAAGGACACAAGTGGGCGCTTCT: CAAGGACACAAGTGGGCGCTTCTG
TCACATACAAACATACTAGTGATA: CACATACAAACATACTAGTGATAA
CGGTCCCCGTACTGTCACATAATG: GGTCCCCGTACTGTCACATAATGG
GCAACATTATACCTAAGCTTCAGA: CAACATTATACCTAAGCTTCAGAG
GTATCAATGTTGACATCAAACGTT: TATCAATGTTGACATCAAACGTTA
TGTGTTTGTGTAGCTCAGATATTT: GTGTTTGTGTAGCTCAGATATTTT
GGAACCCGTATTTCAGTAGAAATA: GAACCCGTATTTCAGTAGAAATAG
CGCCGACTTCATCTACAATACGCA: GCCGACTTCATCTACAATACGCAA
CCACAACCAAAGTCATTGTTAGGG: CACAACCAAAGTCATTGTTAGGGA
TCCACACTCCTACGATTATGCCTG: CCACACTCCTACGATTATGCCTGG
CATCAGACCTGTTTCCGATAAGGT: ATCAGACCTGTTTCCGATAAGGTG
ACCGGTCCCCGTACTGTCACATAA: CCGGTCCCCGTACTGTCACATAAT
ACATCAGACCTGTTTCCGATAAGG: CATCAGACCTGTTTCCGATAAGGT
AGAAGGACCCCTTAGATCTAGCTG: GAAGGACCCCTTAGATCTAGCTGC
GGTGTGTATGCATAAGCGGTTTGC: GTGTGTATGCATAAGCGGTTTGCT
GCTGACAATGTCACTTCGGTCCGA: CTGACAATGTCACTTCGGTCCGAG
TGTATGCATAAGCGGTTTGCTGGC: GTATGCATAAGCGGTTTGCTGGCT
ACTATAGAGGCCCGGCGTGAGCAC: CTATAGAGGCCCGGCGTGAGCACG
AGCAATGCTCACTCGGTAAGTAAG: GCAATGCTCACTCGGTAAGTAAGC
GATGGCGACCCGTTCCAACCTGTC: ATGGCGACCCGTTCCAACCTGTCA
CGGCTAGTTGCACGCCACACTACC: GGCTAGTTGCACGCCACACTACCA
GTTGTTAACTTAACAGACGCAGAT: TTGTTAACTTAACAGACGCAGATA
GGTATACTCTCCACTTATTATTGC: GTATACTCTCCACTTATTATTGCG
GCAAGGACTGTAGGCACGAGGGAT: CAAGGACTGTAGGCACGAGGGATA
GATATTGGTTGTCCTACTTCACCG: ATATTGGTTGTCCTACTTCACCGG
GAGAATCAGTTGAACGTTGATGTA: AGAATCAGTTGAACGTTGATGTAA
GGAGCACACAGACTTGCTGAGGAC: GAGCACACAGACTTGCTGAGGACC
AACCTTTTCACAAATAATTCATCG: ACCTTTTCACAAATAATTCATCGT
GCGTTCAGTTAGAAGAGACTAACA: CGTTCAGTTAGAAGAGACTAACAC
CTGCAGAAGTATAGCTGACAATGT: TGCAGAAGTATAGCTGACAATGTC
CCAGGTTGCGGCATAGATGGTTGG: CAGGTTGCGGCATAGATGGTTGGA
CTCGGTAAGTAAGCGTGGCACTCT: TCGGTAAGTAAGCGTGGCACTCTC
TGGATAAACTAAGCGGCTTAGACT: GGATAAACTAAGCGGCTTAGACTC
TTATGGATATTCCGCCAGATATTC: TATGGATATTCCGCCAGATATTCC
TTATGCGCTGAATCGTTTTCGTAG: TATGCGCTGAATCGTTTTCGTAGC
CGGCATAGATGGTTGGATGCAGAA: GGCATAGATGGTTGGATGCAGAAG
TAAACGGGCGGGTATTTCCTGTGG: AAACGGGCGGGTATTTCCTGTGGC
TTTGCGCACGGTTAGAGGCATCTG: TTGCGCACGGTTAGAGGCATCTGC
CACGGTTAGAGGCATCTGCGTTCC: ACGGTTAGAGGCATCTGCGTTCCT
CTAACCTACTGCTGACATTCCCCC: TAACCTACTGCTGACATTCCCCCG
CGTCAGACTGGTCAGTGAAACGGA: GTCAGACTGGTCAGTGAAACGGAA
CCATCGAGCTGTTCAACTTGGCAG: CATCGAGCTGTTCAACTTGGCAGC
GACCCGAGGAATCCGGATGAATCT: ACCCGAGGAATCCGGATGAATCTC
GCCTCTATACAGTGATTTACGCTT: CCTCTATACAGTGATTTACGCTTA
TTCGCCTCTACCAAAATCCTTCCA: TCGCCTCTACCAAAATCCTTCCAC
GCACCATCAAAAGATAACACGCAC: CACCATCAAAAGATAACACGCACA
ACCGTCGGCGGGTTGTTAACTTAA: CCGTCGGCGGGTTGTTAACTTAAC
GGTATTTCCTGTGGCCAAGTCCTC: GTATTTCCTGTGGCCAAGTCCTCT
CCCCGTGCGGCCGTCTGCGTGTCC: CCCGTGCGGCCGTCTGCGTGTCCA
ATAACCGAGCCCCAACAGGTGGAT: TAACCGAGCCCCAACAGGTGGATA
GTTGAACGTTGATGTAAGCACATT: TTGAACGTTGATGTAAGCACATTG
CCTCTATACAGTGATTTACGCTTA: CTCTATACAGTGATTTACGCTTAG
CTGACAATGTCACTTCGGTCCGAG: TGACAATGTCACTTCGGTCCGAGG
TAACCTTTTCACAAATAATTCATC: AACCTTTTCACAAATAATTCATCG
TCACTGCACAATGATGGCGACCCG: CACTGCACAATGATGGCGACCCGT
AGGGCAACGACGCGCCATGGAGCA: GGGCAACGACGCGCCATGGAGCAC
GAGCTGTTCAACTTGGCAGCATAG: AGCTGTTCAACTTGGCAGCATAGC
GCCCCCTAGGTAAGGCGGTCACTG: CCCCCTAGGTAAGGCGGTCACTGC
TTGGGCAAATAACTACAATGCTGG: TGGGCAAATAACTACAATGCTGGA
AGCTTCAGAGTCCGAGTATTAGCA: GCTTCAGAGTCCGAGTATTAGCAC
GTATTCCTCTCATGTTGCACGTTT: TATTCCTCTCATGTTGCACGTTTG
TTGCCATACATGTGGATACGTCTC: TGCCATACATGTGGATACGTCTCT
TTAACAAGTTAAGCGATTTTACTT: TAACAAGTTAAGCGATTTTACTTA
TGTTGGACGTTTCTCGCACGTGCT: GTTGGACGTTTCTCGCACGTGCTG
AGAGTTTTAGCCGAATGTTTCTCA: GAGTTTTAGCCGAATGTTTCTCAC
ACGAATCTAGCACCAAAGCTCCGT: CGAATCTAGCACCAAAGCTCCGTA
TTTGTCCACGAATCTTTCCCCTCC: TTGTCCACGAATCTTTCCCCTCCC
AGCGGCTTAGACTCTTGAAGGGCA: GCGGCTTAGACTCTTGAAGGGCAA
GATACGTCTCTAATACCCTCGGAG: ATACGTCTCTAATACCCTCGGAGG
AGTTCCTAATCAGACTGTTTAGGG: GTTCCTAATCAGACTGTTTAGGGC
ACAGGCCGAGAGGATCGTAGTGTA: CAGGCCGAGAGGATCGTAGTGTAA
CGTAAAAGACCTCAATATAAACAT: GTAAAAGACCTCAATATAAACATT
TTCGGTACAGAATACCAGTACAGG: TCGGTACAGAATACCAGTACAGGT
ACGCGCCATGGAGCACACAGACTT: CGCGCCATGGAGCACACAGACTTG
CTAACCTTTTCACAAATAATTCAT: TAACCTTTTCACAAATAATTCATC
GATAACACGCACATGTTTACTATA: ATAACACGCACATGTTTACTATAC
CCAGATATTCCCGACTATTCGGTA: CAGATATTCCCGACTATTCGGTAC
AACCAGTTGTCTCAGGTAAATTGA: ACCAGTTGTCTCAGGTAAATTGAG
TGGAAAGTCCTTTATTTGCGCACG: GGAAAGTCCTTTATTTGCGCACGG
TCCACTTATTATTGCGTGGCATGC: CCACTTATTATTGCGTGGCATGCG
AGGCCGAGAGGATCGTAGTGTAAA: GGCCGAGAGGATCGTAGTGTAAAA
GACTGTAGGCACGAGGGATATTGG: ACTGTAGGCACGAGGGATATTGGT
GAATCCGGATGAATCTCTGCAGAG: AATCCGGATGAATCTCTGCAGAGT
AGAACCTTTTCCCATCGAGCTGTT: GAACCTTTTCCCATCGAGCTGTTC
TTAACTTAACAGACGCAGATACCG: TAACTTAACAGACGCAGATACCGG
CAATGATGGCGACCCGTTCCAACC: AATGATGGCGACCCGTTCCAACCT
CGTGAGCACGTATTCCTCTCATGT: GTGAGCACGTATTCCTCTCATGTT
CAGCGTTCAGTTAGAAGAGACTAA: AGCGTTCAGTTAGAAGAGACTAAC
CACCGGCTAGTTGCACGCCACACT: ACCGGCTAGTTGCACGCCACACTA
TTTTTTTGCGAGTATCAATGTTGA: TTTTTTGCGAGTATCAATGTTGAC
TCAGTTGAACGTTGATGTAAGCAC: CAGTTGAACGTTGATGTAAGCACA
AAGGACACAAGTGGGCGCTTCTGC: AGGACACAAGTGGGCGCTTCTGCT
TAAGTAAGCGTGGCACTCTCGTCC: AAGTAAGCGTGGCACTCTCGTCCT
GTTCCAACCTGTCACGTAAAAGAC: TTCCAACCTGTCACGTAAAAGACC
GAACATGTGTTTGTGTAGCTCAGA: AACATGTGTTTGTGTAGCTCAGAT
AGACGCAGATACCGGCGAACATGC: GACGCAGATACCGGCGAACATGCC
GTATAGCTGACAATGTCACTTCGG: TATAGCTGACAATGTCACTTCGGT
ATCTAGCACCAAAGCTCCGTACCC: TCTAGCACCAAAGCTCCGTACCCC
GCAGCATAGCAAGGACTGTAGGCA: CAGCATAGCAAGGACTGTAGGCAC
CAGCCGTGTGAAAAAAGTACGTTA: AGCCGTGTGAAAAAAGTACGTTAA
GTACTGTCACATAATGGATCCAAC: TACTGTCACATAATGGATCCAACC
CTCCTACGATTATGCCTGGCCACT: TCCTACGATTATGCCTGGCCACTT
TAGACTCTTGAAGGGCAACGACGC: AGACTCTTGAAGGGCAACGACGCG
CTGAGCCCTCGGATCCCATAACAT: TGAGCCCTCGGATCCCATAACATC
TCGGTACAGAATACCAGTACAGGT: CGGTACAGAATACCAGTACAGGTT
GTAAGAGTTGGGACGAATCTAGCA: TAAGAGTTGGGACGAATCTAGCAC
GTGAAACGGAACACTTAAACGGGC: TGAAACGGAACACTTAAACGGGCG
GCACATTGTACGATGTTGGACGTT: CACATTGTACGATGTTGGACGTTT
ACACAAGTGGGCGCTTCTGCTATA: CACAAGTGGGCGCTTCTGCTATAC
CTATAGAGGCCCGGCGTGAGCACG: TATAGAGGCCCGGCGTGAGCACGT
TTCAGTTAGAAGAGACTAACACTG: TCAGTTAGAAGAGACTAACACTGT
AAGTTGTGCGTAAATGGGTTAGGG: AGTTGTGCGTAAATGGGTTAGGGA
GCACGAGGGATATTGGTTGTCCTA: CACGAGGGATATTGGTTGTCCTAC
CGGTCCGAGGCAGCAATGCTCACT: GGTCCGAGGCAGCAATGCTCACTC
AATAATTCATCGTGTCGTGCGCCC: ATAATTCATCGTGTCGTGCGCCCC
GTAGAAATAGGAACACACGAGTCC: TAGAAATAGGAACACACGAGTCCA
TTAATCCATTGGCGAGTTGAAACC: TAATCCATTGGCGAGTTGAAACCG
TACTAGAGGGGCAAAGCACAGGCC: ACTAGAGGGGCAAAGCACAGGCCG
TATTCCTCTCATGTTGCACGTTTG: ATTCCTCTCATGTTGCACGTTTGT
ACTGTAGGCACGAGGGATATTGGT: CTGTAGGCACGAGGGATATTGGTT
GCCTCGTTGGCCTCTTCCACTAAC: CCTCGTTGGCCTCTTCCACTAACA
CGAATCTTTCCCCTCCCTCAGCCA: GAATCTTTCCCCTCCCTCAGCCAG
GCTGAGGACCCGAGGAATCCGGAT: CTGAGGACCCGAGGAATCCGGATG
AGCCGTGTGAAAAAAGTACGTTAA: GCCGTGTGAAAAAAGTACGTTAAC
TCCATTGGCGAGTTGAAACCGTCA: CCATTGGCGAGTTGAAACCGTCAG
CCATACATGTGGATACGTCTCTAA: CATACATGTGGATACGTCTCTAAT
TAGTGCACCATCAAAAGATAACAC: AGTGCACCATCAAAAGATAACACG
TTACTATACTAGAGGGGCAAAGCA: TACTATACTAGAGGGGCAAAGCAC
TACTGGTATACTCTCCACTTATTA: ACTGGTATACTCTCCACTTATTAT
ACAGGTTAGTGCACCATCAAAAGA: CAGGTTAGTGCACCATCAAAAGAT
TAACTTAACAGACGCAGATACCGG: AACTTAACAGACGCAGATACCGGC
AGTAGCCTCTATACAGTGATTTAC: GTAGCCTCTATACAGTGATTTACG
TCAGACTGTTTAGGGCTTCGACGC: CAGACTGTTTAGGGCTTCGACGCG
TAGTGATAACCGAGCCCCAACAGG: AGTGATAACCGAGCCCCAACAGGT
GTACAGGTTCTGCAGAAGTATAGC: TACAGGTTCTGCAGAAGTATAGCT
ATGGATCCAACCAGGTGACCCACG: TGGATCCAACCAGGTGACCCACGG
ATGGACAGAGTTTTAGCCGAATGT: TGGACAGAGTTTTAGCCGAATGTT
ACTCTCCACTTATTATTGCGTGGC: CTCTCCACTTATTATTGCGTGGCA
ACGTTATGCGCTGAATCGTTTTCG: CGTTATGCGCTGAATCGTTTTCGT
TTTATTTGCGCACGGTTAGAGGCA: TTATTTGCGCACGGTTAGAGGCAT
CATTGTTAGGGATTCCACACTCCT: ATTGTTAGGGATTCCACACTCCTA
TGACGCCCGCTCAGGAACCCGTAT: GACGCCCGCTCAGGAACCCGTATT
ACGTGCTGCTTTATCCGGCCCGTC: CGTGCTGCTTTATCCGGCCCGTCA
GACGCCCGCTCAGGAACCCGTATT: ACGCCCGCTCAGGAACCCGTATTT
AGTGTGAGGTTAAGCTTTTGCTGG: GTGTGAGGTTAAGCTTTTGCTGGT
ATTAATCCATTGGCGAGTTGAAAC: TTAATCCATTGGCGAGTTGAAACC
ACGACGCGCCATGGAGCACACAGA: CGACGCGCCATGGAGCACACAGAC
ACGGTGATGCATGGACAGAGTTTT: CGGTGATGCATGGACAGAGTTTTA
ATTATGCCTGGCCACTTCTGAGCC: TTATGCCTGGCCACTTCTGAGCCC
CTTTTCACAAATAATTCATCGTGT: TTTTCACAAATAATTCATCGTGTC
GTTTCCGATAAGGTGCACCTAACC: TTTCCGATAAGGTGCACCTAACCT
CGTGTGAAAAAAGTACGTTAACTT: GTGTGAAAAAAGTACGTTAACTTG
CGCTTCGCGGAAGAACAGGATTAA: GCTTCGCGGAAGAACAGGATTAAT
CACATGTTTACTATACTAGAGGGG: ACATGTTTACTATACTAGAGGGGC
GAGGCATCTGCGTTCCTGAATGCA: AGGCATCTGCGTTCCTGAATGCAG
GAGTCCGAGTATTAGCACGTGGGA: AGTCCGAGTATTAGCACGTGGGAA
CATTGGCGAGTTGAAACCGTCAGA: ATTGGCGAGTTGAAACCGTCAGAC
TAAGGCGGTCACTGCACAATGATG: AAGGCGGTCACTGCACAATGATGG
CGCAGATACCGGCGAACATGCCGA: GCAGATACCGGCGAACATGCCGAT
CCGAGAGGATCGTAGTGTAAAAAC: CGAGAGGATCGTAGTGTAAAAACT
GACAATGTCACTTCGGTCCGAGGC: ACAATGTCACTTCGGTCCGAGGCA
CAGACTTGCTGAGGACCCGAGGAA: AGACTTGCTGAGGACCCGAGGAAT
AAGGTGCACCTAACCTTTTCACAA: AGGTGCACCTAACCTTTTCACAAA
GAGCACGTATTCCTCTCATGTTGC: AGCACGTATTCCTCTCATGTTGCA
GTGGATACGTCTCTAATACCCTCG: TGGATACGTCTCTAATACCCTCGG
GTGCGCCCCCTAGGTAAGGCGGTC: TGCGCCCCCTAGGTAAGGCGGTCA
GAAAGAACCTTTTCCCATCGAGCT: AAAGAACCTTTTCCCATCGAGCTG
CAATGTCACTTCGGTCCGAGGCAG: AATGTCACTTCGGTCCGAGGCAGC
CACATAATGGATCCAACCAGGTGA: ACATAATGGATCCAACCAGGTGAC
CCACTTATTATTGCGTGGCATGCG: CACTTATTATTGCGTGGCATGCGT
TAAGCGTGGCACTCTCGTCCTTAA: AAGCGTGGCACTCTCGTCCTTAAC
AGGCCCGGCGTGAGCACGTATTCC: GGCCCGGCGTGAGCACGTATTCCT
TCATCTACAATACGCAAGGACACA: CATCTACAATACGCAAGGACACAA
CACGTATTCCTCTCATGTTGCACG: ACGTATTCCTCTCATGTTGCACGT
CCTAATCAGACTGTTTAGGGCTTC: CTAATCAGACTGTTTAGGGCTTCG
GGCAAGGCAACATTATACCTAAGC: GCAAGGCAACATTATACCTAAGCT
TCGCACGTGCTGCTTTATCCGGCC: CGCACGTGCTGCTTTATCCGGCCC
CTTCACCGGCTAGTTGCACGCCAC: TTCACCGGCTAGTTGCACGCCACA
AACTCCACAACCAAAGTCATTGTT: ACTCCACAACCAAAGTCATTGTTA
TTAGGTATTATATGCTAACCTACT: TAGGTATTATATGCTAACCTACTG
TCCGGCCCGTCAGCGTTCAGTTAG: CCGGCCCGTCAGCGTTCAGTTAGA
CACAATGATGGCGACCCGTTCCAA: ACAATGATGGCGACCCGTTCCAAC
CTGTGGCCAAGTCCTCTCTCGTCA: TGTGGCCAAGTCCTCTCTCGTCAG
ACATTCCCCCGTGCGGCCGTCTGC: CATTCCCCCGTGCGGCCGTCTGCG
GTATACTCTCCACTTATTATTGCG: TATACTCTCCACTTATTATTGCGT
ACGTATTCCTCTCATGTTGCACGT: CGTATTCCTCTCATGTTGCACGTT
CTACTTCACCGGCTAGTTGCACGC: TACTTCACCGGCTAGTTGCACGCC
GGTACAGAATACCAGTACAGGTTC: GTACAGAATACCAGTACAGGTTCT
CGTAAATGGGTTAGGGAGGTGTTC: GTAAATGGGTTAGGGAGGTGTTCT
AGGGGCAAAGCACAGGCCGAGAGG: GGGGCAAAGCACAGGCCGAGAGGA
AAAAAAGTACGTTAACTTGGTAGG: AAAAAGTACGTTAACTTGGTAGGT
AACACGCTGAAAAAAATGCCAGGT: ACACGCTGAAAAAAATGCCAGGTG
GTACAGAATACCAGTACAGGTTCT: TACAGAATACCAGTACAGGTTCTG
TGGTTGGATGCAGAAGGACCCCTT: GGTTGGATGCAGAAGGACCCCTTA
AGTACAGGTTCTGCAGAAGTATAG: GTACAGGTTCTGCAGAAGTATAGC
TCCCCGTACTGTCACATAATGGAT: CCCCGTACTGTCACATAATGGATC
TTCACCGGCTAGTTGCACGCCACA: TCACCGGCTAGTTGCACGCCACAC
CTGTAGGCACGAGGGATATTGGTT: TGTAGGCACGAGGGATATTGGTTG
CAACCAGTTGTCTCAGGTAAATTG: AACCAGTTGTCTCAGGTAAATTGA
TGGTGTCTCTCCGGCGCCACCGCC: GGTGTCTCTCCGGCGCCACCGCCT
TTAGATCTAGCTGCAGTTGGCGCC: TAGATCTAGCTGCAGTTGGCGCCC
AAGGACTGTAGGCACGAGGGATAT: AGGACTGTAGGCACGAGGGATATT
ATGGGTTAGGGAGGTGTTCTTATA: TGGGTTAGGGAGGTGTTCTTATAG
CGGCGGGTTGTTAACTTAACAGAC: GGCGGGTTGTTAACTTAACAGACG
TTTGCTGGTGTTTCTTGGATCGTG: TTGCTGGTGTTTCTTGGATCGTGC
TGTGGCCAAGTCCTCTCTCGTCAG: GTGGCCAAGTCCTCTCTCGTCAGT
CTATACAGTGATTTACGCTTAGGT: TATACAGTGATTTACGCTTAGGTA
CTAACACACCTTGGTGCAGGACCT: TAACACACCTTGGTGCAGGACCTC
CTGCAGAGTCAGTAGCCTCTATAC: TGCAGAGTCAGTAGCCTCTATACA
AATGCGAACCTTGCCATACATGTG: ATGCGAACCTTGCCATACATGTGG
TTAACTTGGTAGGTGTATGAATCG: TAACTTGGTAGGTGTATGAATCGT
CCTAAGCTTCAGAGTCCGAGTATT: CTAAGCTTCAGAGTCCGAGTATTA
CAGGTTAGTGCACCATCAAAAGAT: AGGTTAGTGCACCATCAAAAGATA
ATAGCTGACAATGTCACTTCGGTC: TAGCTGACAATGTCACTTCGGTCC
TGGGAAAATACCGGGCAATAGTGA: GGGAAAATACCGGGCAATAGTGAC
GAATCAGTTGAACGTTGATGTAAG: AATCAGTTGAACGTTGATGTAAGC
GATTAATCCATTGGCGAGTTGAAA: ATTAATCCATTGGCGAGTTGAAAC
AGCATGGAAAGAACCTTTTCCCAT: GCATGGAAAGAACCTTTTCCCATC
ATACAGGTGTCCCACATACTGACT: TACAGGTGTCCCACATACTGACTT
CTGTTTCCGATAAGGTGCACCTAA: TGTTTCCGATAAGGTGCACCTAAC
CACTACCAACAGGGCGAACATGTG: ACTACCAACAGGGCGAACATGTGT
CAATAGTGACAAAGGGTTGGGCAA: AATAGTGACAAAGGGTTGGGCAAA
CGCAAGGACACAAGTGGGCGCTTC: GCAAGGACACAAGTGGGCGCTTCT
GCGGCTTAGACTCTTGAAGGGCAA: CGGCTTAGACTCTTGAAGGGCAAC
TGCATAAGCGGTTTGCTGGCTTGG: GCATAAGCGGTTTGCTGGCTTGGG
AGCGATTTTACTTATCTGAGCCAT: GCGATTTTACTTATCTGAGCCATG
ATAGAGGCCCGGCGTGAGCACGTA: TAGAGGCCCGGCGTGAGCACGTAT
TTGCGCTTCGCGGAAGAACAGGAT: TGCGCTTCGCGGAAGAACAGGATT
GTGCGCCGACTTCATCTACAATAC: TGCGCCGACTTCATCTACAATACG
AAGAACCTTTTCCCATCGAGCTGT: AGAACCTTTTCCCATCGAGCTGTT
ACATACTGACTTGCGCTTCGCGGA: CATACTGACTTGCGCTTCGCGGAA
GAGGCAGCAATGCTCACTCGGTAA: AGGCAGCAATGCTCACTCGGTAAG
ACCTCAATATAAACATTATGGATA: CCTCAATATAAACATTATGGATAT
TGAAGGGCAACGACGCGCCATGGA: GAAGGGCAACGACGCGCCATGGAG
GAGCACCGGTCCCCGTACTGTCAC: AGCACCGGTCCCCGTACTGTCACA
GAGTATTAGCACGTGGGAAAATAC: AGTATTAGCACGTGGGAAAATACC
CACCTTGGTGCAGGACCTCAGTGT: ACCTTGGTGCAGGACCTCAGTGTG
GTTAACTTGGTAGGTGTATGAATC: TTAACTTGGTAGGTGTATGAATCG
GTTTGTCCAATTCAATCGCTACTT: TTTGTCCAATTCAATCGCTACTTT
TCACAAATAATTCATCGTGTCGTG: CACAAATAATTCATCGTGTCGTGC
ATAAGCGGTTTGCTGGCTTGGGCA: TAAGCGGTTTGCTGGCTTGGGCAA
TATACAGTGATTTACGCTTAGGTA: ATACAGTGATTTACGCTTAGGTAT
TTGGCAGCATAGCAAGGACTGTAG: TGGCAGCATAGCAAGGACTGTAGG
GAATCTTTCCCCTCCCTCAGCCAG: AATCTTTCCCCTCCCTCAGCCAGG
AGACCTCAATATAAACATTATGGA: GACCTCAATATAAACATTATGGAT
AGAAGTATAGCTGACAATGTCACT: GAAGTATAGCTGACAATGTCACTT
TCCACGGTGCGCTAACGGTGATGC: CCACGGTGCGCTAACGGTGATGCA
ATAAACATTATGGATATTCCGCCA: TAAACATTATGGATATTCCGCCAG
ACGCGCCTTACTGGTGTCTCTCCG: CGCGCCTTACTGGTGTCTCTCCGG
ATCCAACCAGGTGACCCACGGTGT: TCCAACCAGGTGACCCACGGTGTG
GTGGGAAAATACCGGGCAATAGTG: TGGGAAAATACCGGGCAATAGTGA
ACCTACTGCTGACATTCCCCCGTG: CCTACTGCTGACATTCCCCCGTGC
TACAATGCTGGAAAGTCCTTTATT: ACAATGCTGGAAAGTCCTTTATTT
TAGATCTAGCTGCAGTTGGCGCCC: AGATCTAGCTGCAGTTGGCGCCCA
TATTTCCTGTGGCCAAGTCCTCTC: ATTTCCTGTGGCCAAGTCCTCTCT
AATGCCAGGTGTAGAGAATCAGTT: ATGCCAGGTGTAGAGAATCAGTTG
TCAGTTAGAAGAGACTAACACTGT: CAGTTAGAAGAGACTAACACTGTT
GCGGCCGTCTGCGTGTCCAAAAGT: CGGCCGTCTGCGTGTCCAAAAGTT
CCTCTACCAAAATCCTTCCACGGA: CTCTACCAAAATCCTTCCACGGAC
TACCTAAGCTTCAGAGTCCGAGTA: ACCTAAGCTTCAGAGTCCGAGTAT
AGTCAGTAGCCTCTATACAGTGAT: GTCAGTAGCCTCTATACAGTGATT
TTTTCGTAGCATGGAAAGAACCTT: TTTCGTAGCATGGAAAGAACCTTT
ACTGACTTGCGCTTCGCGGAAGAA: CTGACTTGCGCTTCGCGGAAGAAC
GGCAACGACGCGCCATGGAGCACA: GCAACGACGCGCCATGGAGCACAC
GTAACACGCTGAAAAAAATGCCAG: TAACACGCTGAAAAAAATGCCAGG
TATAGCTGACAATGTCACTTCGGT: ATAGCTGACAATGTCACTTCGGTC
CGACCCGTTCCAACCTGTCACGTA: GACCCGTTCCAACCTGTCACGTAA
CCAAGTCCTCTCTCGTCAGTTTGT: CAAGTCCTCTCTCGTCAGTTTGTG
AGGCGGTCACTGCACAATGATGGC: GGCGGTCACTGCACAATGATGGCG
CGGAACACTTAAACGGGCGGGTAT: GGAACACTTAAACGGGCGGGTATT
TGAAACCGTCAGACTGGTCAGTGA: GAAACCGTCAGACTGGTCAGTGAA
GGCAAAGCACAGGCCGAGAGGATC: GCAAAGCACAGGCCGAGAGGATCG
AGGTAAATTGAGACTATAGAGGCC: GGTAAATTGAGACTATAGAGGCCC
CACGAGTCCACGGTGCGCTAACGG: ACGAGTCCACGGTGCGCTAACGGT
CACACAGACTTGCTGAGGACCCGA: ACACAGACTTGCTGAGGACCCGAG
AACCAGGTGACCCACGGTGTGTAT: ACCAGGTGACCCACGGTGTGTATG
TACATGTGGATACGTCTCTAATAC: ACATGTGGATACGTCTCTAATACC
TCTCACTTGATCCACAGGTTAGTG: CTCACTTGATCCACAGGTTAGTGC
TAAGAGTTGGGACGAATCTAGCAC: AAGAGTTGGGACGAATCTAGCACC
GAAAAAAATGCCAGGTGTAGAGAA: AAAAAAATGCCAGGTGTAGAGAAT
GTTGATGTAAGCACATTGTACGAT: TTGATGTAAGCACATTGTACGATG
TTCCGCCAGATATTCCCGACTATT: TCCGCCAGATATTCCCGACTATTC
ATCTGCGTTCCTGAATGCAGTTCC: TCTGCGTTCCTGAATGCAGTTCCT
CCATGAGCACCGGTCCCCGTACTG: CATGAGCACCGGTCCCCGTACTGT
GCATAGATGGTTGGATGCAGAAGG: CATAGATGGTTGGATGCAGAAGGA
CAGGTTGCGGCATAGATGGTTGGA: AGGTTGCGGCATAGATGGTTGGAT
CACATACTGACTTGCGCTTCGCGG: ACATACTGACTTGCGCTTCGCGGA
TAAAAACTCCACAACCAAAGTCAT: AAAAACTCCACAACCAAAGTCATT
AATAGGAACACACGAGTCCACGGT: ATAGGAACACACGAGTCCACGGTG
CACACGAGTCCACGGTGCGCTAAC: ACACGAGTCCACGGTGCGCTAACG
AGTATTAGCACGTGGGAAAATACC: GTATTAGCACGTGGGAAAATACCG
TCTAGCACCAAAGCTCCGTACCCC: CTAGCACCAAAGCTCCGTACCCCA
ATACCGGGCAATAGTGACAAAGGG: TACCGGGCAATAGTGACAAAGGGT
TGTATGAATCGTGTAACACGCTGA: GTATGAATCGTGTAACACGCTGAA
CGGTTAGAGGCATCTGCGTTCCTG: GGTTAGAGGCATCTGCGTTCCTGA
TACTGCTGACATTCCCCCGTGCGG: ACTGCTGACATTCCCCCGTGCGGC
GGCTTGGGCAAGGCAACATTATAC: GCTTGGGCAAGGCAACATTATACC
CTATTCGGTACAGAATACCAGTAC: TATTCGGTACAGAATACCAGTACA
GACTTGCTGAGGACCCGAGGAATC: ACTTGCTGAGGACCCGAGGAATCC
AGCCTCTATACAGTGATTTACGCT: GCCTCTATACAGTGATTTACGCTT
ACTTACAATGCGAACCTTGCCATA: CTTACAATGCGAACCTTGCCATAC
ACGTTTCTCGCACGTGCTGCTTTA: CGTTTCTCGCACGTGCTGCTTTAT
CCCGTACTGTCACATAATGGATCC: CCGTACTGTCACATAATGGATCCA
GTTTTTTTGCGAGTATCAATGTTG: TTTTTTTGCGAGTATCAATGTTGA
GTCGTGCGCCCCCTAGGTAAGGCG: TCGTGCGCCCCCTAGGTAAGGCGG
CCGAATGTTTCTCACTTGATCCAC: CGAATGTTTCTCACTTGATCCACA
TCCTAATCAGACTGTTTAGGGCTT: CCTAATCAGACTGTTTAGGGCTTC
ACTGGTGTCTCTCCGGCGCCACCG: CTGGTGTCTCTCCGGCGCCACCGC
ATCAGTTGAACGTTGATGTAAGCA: TCAGTTGAACGTTGATGTAAGCAC
CAGGTGACCCACGGTGTGTATGCA: AGGTGACCCACGGTGTGTATGCAT
CGTCCTTAACAAGTTAAGCGATTT: GTCCTTAACAAGTTAAGCGATTTT
TTTGCTGGCTTGGGCAAGGCAACA: TTGCTGGCTTGGGCAAGGCAACAT
CTTCCACGGACAACCAGTTGTCTC: TTCCACGGACAACCAGTTGTCTCA
TGCTGGCTTGGGCAAGGCAACATT: GCTGGCTTGGGCAAGGCAACATTA
AGGACACAAGTGGGCGCTTCTGCT: GGACACAAGTGGGCGCTTCTGCTA
AAAGAACCTTTTCCCATCGAGCTG: AAGAACCTTTTCCCATCGAGCTGT
CACGTGGGAAAATACCGGGCAATA: ACGTGGGAAAATACCGGGCAATAG
GGCGAACATGTGTTTGTGTAGCTC: GCGAACATGTGTTTGTGTAGCTCA
AGGAATCCGGATGAATCTCTGCAG: GGAATCCGGATGAATCTCTGCAGA
TTTTACTTATCTGAGCCATGACTT: TTTACTTATCTGAGCCATGACTTA
GCTCACTCGGTAAGTAAGCGTGGC: CTCACTCGGTAAGTAAGCGTGGCA
CAAAGCTCCGTACCCCATTCGCCT: AAAGCTCCGTACCCCATTCGCCTC
AGGTGTAGAGAATCAGTTGAACGT: GGTGTAGAGAATCAGTTGAACGTT
AGTTGTCTCAGGTAAATTGAGACT: GTTGTCTCAGGTAAATTGAGACTA
TGGCGAGTTGAAACCGTCAGACTG: GGCGAGTTGAAACCGTCAGACTGG
CCCGAGGAATCCGGATGAATCTCT: CCGAGGAATCCGGATGAATCTCTG
GGTGTATGAATCGTGTAACACGCT: GTGTATGAATCGTGTAACACGCTG
AAATCCTTCCACGGACAACCAGTT: AATCCTTCCACGGACAACCAGTTG
AAGCTCCGTACCCCATTCGCCTCT: AGCTCCGTACCCCATTCGCCTCTA
CCACACTACCAACAGGGCGAACAT: CACACTACCAACAGGGCGAACATG
CGCCCCCTAGGTAAGGCGGTCACT: GCCCCCTAGGTAAGGCGGTCACTG
CAGCAATGCTCACTCGGTAAGTAA: AGCAATGCTCACTCGGTAAGTAAG
AGTTTTAGCCGAATGTTTCTCACT: GTTTTAGCCGAATGTTTCTCACTT
ACCAGGTGACCCACGGTGTGTATG: CCAGGTGACCCACGGTGTGTATGC
ACAATGCGAACCTTGCCATACATG: CAATGCGAACCTTGCCATACATGT
GCAAAGCACAGGCCGAGAGGATCG: CAAAGCACAGGCCGAGAGGATCGT
CCATTGGCGAGTTGAAACCGTCAG: CATTGGCGAGTTGAAACCGTCAGA
GACACAAGTGGGCGCTTCTGCTAT: ACACAAGTGGGCGCTTCTGCTATA
AGTGATAACCGAGCCCCAACAGGT: GTGATAACCGAGCCCCAACAGGTG
TGCGCCCCCTAGGTAAGGCGGTCA: GCGCCCCCTAGGTAAGGCGGTCAC
CACGGTGCGCTAACGGTGATGCAT: ACGGTGCGCTAACGGTGATGCATG
TTGAGACTATAGAGGCCCGGCGTG: TGAGACTATAGAGGCCCGGCGTGA
GCTGTTCAACTTGGCAGCATAGCA: CTGTTCAACTTGGCAGCATAGCAA
GAAAGTCCTTTATTTGCGCACGGT: AAAGTCCTTTATTTGCGCACGGTT
AATCTCTGCAGAGTCAGTAGCCTC: ATCTCTGCAGAGTCAGTAGCCTCT
CCCCTAGGTAAGGCGGTCACTGCA: CCCTAGGTAAGGCGGTCACTGCAC
AATTCATCGTGTCGTGCGCCCCCT: ATTCATCGTGTCGTGCGCCCCCTA
GGGCAAAGCACAGGCCGAGAGGAT: GGCAAAGCACAGGCCGAGAGGATC
GACTTGCGCTTCGCGGAAGAACAG: ACTTGCGCTTCGCGGAAGAACAGG
CAGTGTGAGGTTAAGCTTTTGCTG: AGTGTGAGGTTAAGCTTTTGCTGG
CTTCGCGGAAGAACAGGATTAATC: TTCGCGGAAGAACAGGATTAATCC
CGTTTGTCCAATTCAATCGCTACT: GTTTGTCCAATTCAATCGCTACTT
CTCTCATGTTGCACGTTTGTCCAA: TCTCATGTTGCACGTTTGTCCAAT
AATTCAATCGCTACTTTGTCCACG: ATTCAATCGCTACTTTGTCCACGA
CTCTCCGGCGCCACCGCCTCGTTG: TCTCCGGCGCCACCGCCTCGTTGG
TTCATCTACAATACGCAAGGACAC: TCATCTACAATACGCAAGGACACA
CGTGCGCCCCCTAGGTAAGGCGGT: GTGCGCCCCCTAGGTAAGGCGGTC
AATACCAGTACAGGTTCTGCAGAA: ATACCAGTACAGGTTCTGCAGAAG
CGTAGTGTAAAAACTCCACAACCA: GTAGTGTAAAAACTCCACAACCAA
GCTCCGTACCCCATTCGCCTCTAC: CTCCGTACCCCATTCGCCTCTACC
ACCTTGTAAGAGTTGGGACGAATC: CCTTGTAAGAGTTGGGACGAATCT
AAAAGATAACACGCACATGTTTAC: AAAGATAACACGCACATGTTTACT
CTTGCTGAGGACCCGAGGAATCCG: TTGCTGAGGACCCGAGGAATCCGG
ATGCATAAGCGGTTTGCTGGCTTG: TGCATAAGCGGTTTGCTGGCTTGG
CCCGACTATTCGGTACAGAATACC: CCGACTATTCGGTACAGAATACCA
GTGTGAAAAAAGTACGTTAACTTG: TGTGAAAAAAGTACGTTAACTTGG
CCCATGAGCACCGGTCCCCGTACT: CCATGAGCACCGGTCCCCGTACTG
CACATTGTACGATGTTGGACGTTT: ACATTGTACGATGTTGGACGTTTC
ATACAAACATACTAGTGATAACCG: TACAAACATACTAGTGATAACCGA
TCCTCTCTCGTCAGTTTGTGACGC: CCTCTCTCGTCAGTTTGTGACGCC
CCAACAGGTGGATAAACTAAGCGG: CAACAGGTGGATAAACTAAGCGGC
TTGCTGAGGACCCGAGGAATCCGG: TGCTGAGGACCCGAGGAATCCGGA
GATCCACAGGTTAGTGCACCATCA: ATCCACAGGTTAGTGCACCATCAA
TGAGCACCGGTCCCCGTACTGTCA: GAGCACCGGTCCCCGTACTGTCAC
GGCAACATTATACCTAAGCTTCAG: GCAACATTATACCTAAGCTTCAGA
TAGGGCTTCGACGCGCCTTACTGG: AGGGCTTCGACGCGCCTTACTGGT
CCCCTCCCTCAGCCAGGTTGCGGC: CCCTCCCTCAGCCAGGTTGCGGCA
GAACCTTGCCATACATGTGGATAC: AACCTTGCCATACATGTGGATACG
AAGGGCAACGACGCGCCATGGAGC: AGGGCAACGACGCGCCATGGAGCA
ACAATGATGGCGACCCGTTCCAAC: CAATGATGGCGACCCGTTCCAACC
TCCCTCAGCCAGGTTGCGGCATAG: CCCTCAGCCAGGTTGCGGCATAGA
GGGATTCCACACTCCTACGATTAT: GGATTCCACACTCCTACGATTATG
TTTACGCTTAGGTATTATATGCTA: TTACGCTTAGGTATTATATGCTAA
TCTTATAGTATTACTGGTATACTC: CTTATAGTATTACTGGTATACTCT
AGTTGGGACGAATCTAGCACCAAA: GTTGGGACGAATCTAGCACCAAAG
AGTCCTTTATTTGCGCACGGTTAG: GTCCTTTATTTGCGCACGGTTAGA
CCGTCGGCGGGTTGTTAACTTAAC: CGTCGGCGGGTTGTTAACTTAACA
CACGTAAAAGACCTCAATATAAAC: ACGTAAAAGACCTCAATATAAACA
CGCCAGATATTCCCGACTATTCGG: GCCAGATATTCCCGACTATTCGGT
CCACTAACACACCTTGGTGCAGGA: CACTAACACACCTTGGTGCAGGAC
TTGATGTAAGCACATTGTACGATG: TGATGTAAGCACATTGTACGATGT
GTATGAATCGTGTAACACGCTGAA: TATGAATCGTGTAACACGCTGAAA
TTGGGCAAGGCAACATTATACCTA: TGGGCAAGGCAACATTATACCTAA
GTTGGATGCAGAAGGACCCCTTAG: TTGGATGCAGAAGGACCCCTTAGA
CCATGGAGCACACAGACTTGCTGA: CATGGAGCACACAGACTTGCTGAG
ACCATCAAAAGATAACACGCACAT: CCATCAAAAGATAACACGCACATG
TACCAACAGGGCGAACATGTGTTT: ACCAACAGGGCGAACATGTGTTTG
ATACCTAAGCTTCAGAGTCCGAGT: TACCTAAGCTTCAGAGTCCGAGTA
CGCTTAGGTATTATATGCTAACCT: GCTTAGGTATTATATGCTAACCTA
TTCTCACTTGATCCACAGGTTAGT: TCTCACTTGATCCACAGGTTAGTG
TACTTCACCGGCTAGTTGCACGCC: ACTTCACCGGCTAGTTGCACGCCA
AAAGACCTCAATATAAACATTATG: AAGACCTCAATATAAACATTATGG
ATCTTTCCCCTCCCTCAGCCAGGT: TCTTTCCCCTCCCTCAGCCAGGTT
CACATACAAACATACTAGTGATAA: ACATACAAACATACTAGTGATAAC
TTGTAAGAGTTGGGACGAATCTAG: TGTAAGAGTTGGGACGAATCTAGC
ATCTCTGCAGAGTCAGTAGCCTCT: TCTCTGCAGAGTCAGTAGCCTCTA
CAGCATAGCAAGGACTGTAGGCAC: AGCATAGCAAGGACTGTAGGCACG
TACTGACTTGCGCTTCGCGGAAGA: ACTGACTTGCGCTTCGCGGAAGAA
GAGGGGCAAAGCACAGGCCGAGAG: AGGGGCAAAGCACAGGCCGAGAGG
AATGCTGGAAAGTCCTTTATTTGC: ATGCTGGAAAGTCCTTTATTTGCG
TCGTGTCGTGCGCCCCCTAGGTAA: CGTGTCGTGCGCCCCCTAGGTAAG
AAAACTCCACAACCAAAGTCATTG: AAACTCCACAACCAAAGTCATTGT
ATACCAGTACAGGTTCTGCAGAAG: TACCAGTACAGGTTCTGCAGAAGT
CATCAAACGTTATGCGCTGAATCG: ATCAAACGTTATGCGCTGAATCGT
GCGATTTTACTTATCTGAGCCATG: CGATTTTACTTATCTGAGCCATGA
GATGTAAGCACATTGTACGATGTT: ATGTAAGCACATTGTACGATGTTG
CATTCCCCCGTGCGGCCGTCTGCG: ATTCCCCCGTGCGGCCGTCTGCGT
CAATACGCAAGGACACAAGTGGGC: AATACGCAAGGACACAAGTGGGCG
ATTCGCCTCTACCAAAATCCTTCC: TTCGCCTCTACCAAAATCCTTCCA
TACGATTATGCCTGGCCACTTCTG: ACGATTATGCCTGGCCACTTCTGA
CCTCTCATGTTGCACGTTTGTCCA: CTCTCATGTTGCACGTTTGTCCAA
AAGTCCTCTCTCGTCAGTTTGTGA: AGTCCTCTCTCGTCAGTTTGTGAC
TGTCCACGAATCTTTCCCCTCCCT: GTCCACGAATCTTTCCCCTCCCTC
TACCCTCGGAGGCCCAGCCGTGTG: ACCCTCGGAGGCCCAGCCGTGTGA
TTTCTTGGATCGTGCGCCGACTTC: TTCTTGGATCGTGCGCCGACTTCA
AGACTTGCTGAGGACCCGAGGAAT: GACTTGCTGAGGACCCGAGGAATC
AACTTAACAGACGCAGATACCGGC: ACTTAACAGACGCAGATACCGGCG
GCGCTTCGCGGAAGAACAGGATTA: CGCTTCGCGGAAGAACAGGATTAA
TGTTTCCGATAAGGTGCACCTAAC: GTTTCCGATAAGGTGCACCTAACC
TAACTTGGTAGGTGTATGAATCGT: AACTTGGTAGGTGTATGAATCGTG
TACTTTGTCCACGAATCTTTCCCC: ACTTTGTCCACGAATCTTTCCCCT
CATTATACCTAAGCTTCAGAGTCC: ATTATACCTAAGCTTCAGAGTCCG
TCCAAAAGTTGTGCGTAAATGGGT: CCAAAAGTTGTGCGTAAATGGGTT
GGTTAGAGGCATCTGCGTTCCTGA: GTTAGAGGCATCTGCGTTCCTGAA
ATGCAGTTCCTAATCAGACTGTTT: TGCAGTTCCTAATCAGACTGTTTA
TGCGGCATAGATGGTTGGATGCAG: GCGGCATAGATGGTTGGATGCAGA
CCGGCTAGTTGCACGCCACACTAC: CGGCTAGTTGCACGCCACACTACC
ACTATACTAGAGGGGCAAAGCACA: CTATACTAGAGGGGCAAAGCACAG
CGTGACCTTGTAAGAGTTGGGACG: GTGACCTTGTAAGAGTTGGGACGA
GCACAATGATGGCGACCCGTTCCA: CACAATGATGGCGACCCGTTCCAA
CCTGTCACGTAAAAGACCTCAATA: CTGTCACGTAAAAGACCTCAATAT
GTCCAATTCAATCGCTACTTTGTC: TCCAATTCAATCGCTACTTTGTCC
TCAATCGCTACTTTGTCCACGAAT: CAATCGCTACTTTGTCCACGAATC
ATGAATCGTGTAACACGCTGAAAA: TGAATCGTGTAACACGCTGAAAAA
TTTTCCCATCGAGCTGTTCAACTT: TTTCCCATCGAGCTGTTCAACTTG
GCTTAGACTCTTGAAGGGCAACGA: CTTAGACTCTTGAAGGGCAACGAC
GCATAAGCGGTTTGCTGGCTTGGG: CATAAGCGGTTTGCTGGCTTGGGC
ACTCTTGAAGGGCAACGACGCGCC: CTCTTGAAGGGCAACGACGCGCCA
GGATGCAGAAGGACCCCTTAGATC: GATGCAGAAGGACCCCTTAGATCT
TCCTACTTCACCGGCTAGTTGCAC: CCTACTTCACCGGCTAGTTGCACG
CAGAGTCAGTAGCCTCTATACAGT: AGAGTCAGTAGCCTCTATACAGTG
CTCATGTTGCACGTTTGTCCAATT: TCATGTTGCACGTTTGTCCAATTC
CCGATAAGGTGCACCTAACCTTTT: CGATAAGGTGCACCTAACCTTTTC
GACCTTGTAAGAGTTGGGACGAAT: ACCTTGTAAGAGTTGGGACGAATC
GGTTCTGCAGAAGTATAGCTGACA: GTTCTGCAGAAGTATAGCTGACAA
ACTAACACACCTTGGTGCAGGACC: CTAACACACCTTGGTGCAGGACCT
TTCCTCTCATGTTGCACGTTTGTC: TCCTCTCATGTTGCACGTTTGTCC
GCGACCCGTTCCAACCTGTCACGT: CGACCCGTTCCAACCTGTCACGTA
AGAATACCAGTACAGGTTCTGCAG: GAATACCAGTACAGGTTCTGCAGA
AAATGGGTTAGGGAGGTGTTCTTA: AATGGGTTAGGGAGGTGTTCTTAT
AGAGTTGGGACGAATCTAGCACCA: GAGTTGGGACGAATCTAGCACCAA
ACACTGTTTTTTTGCGAGTATCAA: CACTGTTTTTTTGCGAGTATCAAT
GAATCGTTTTCGTAGCATGGAAAG: AATCGTTTTCGTAGCATGGAAAGA
CATGCCGATACGTCACATACAAAC: ATGCCGATACGTCACATACAAACA
AGGCAGCAATGCTCACTCGGTAAG: GGCAGCAATGCTCACTCGGTAAGT
ACCGTCAGACTGGTCAGTGAAACG: CCGTCAGACTGGTCAGTGAAACGG
ACATGCCGATACGTCACATACAAA: CATGCCGATACGTCACATACAAAC
CTAGGTAAGGCGGTCACTGCACAA: TAGGTAAGGCGGTCACTGCACAAT
CGCCACACTACCAACAGGGCGAAC: GCCACACTACCAACAGGGCGAACA
TCTGAGCCCTCGGATCCCATAACA: CTGAGCCCTCGGATCCCATAACAT
AATCGTGTAACACGCTGAAAAAAA: ATCGTGTAACACGCTGAAAAAAAT
GTGAGGTTAAGCTTTTGCTGGTGT: TGAGGTTAAGCTTTTGCTGGTGTT
TTAGTGCACCATCAAAAGATAACA: TAGTGCACCATCAAAAGATAACAC
ATCGTAGTGTAAAAACTCCACAAC: TCGTAGTGTAAAAACTCCACAACC
CCGAGTATTAGCACGTGGGAAAAT: CGAGTATTAGCACGTGGGAAAATA
TATACAGGTGTCCCACATACTGAC: ATACAGGTGTCCCACATACTGACT
TCTCTCGTCAGTTTGTGACGCCCG: CTCTCGTCAGTTTGTGACGCCCGC
CCTGGCCACTTCTGAGCCCTCGGA: CTGGCCACTTCTGAGCCCTCGGAT
GTCTGCGTGTCCAAAAGTTGTGCG: TCTGCGTGTCCAAAAGTTGTGCGT
TGGTCAGTGAAACGGAACACTTAA: GGTCAGTGAAACGGAACACTTAAA
CCCGGCGTGAGCACGTATTCCTCT: CCGGCGTGAGCACGTATTCCTCTC
GACGAATCTAGCACCAAAGCTCCG: ACGAATCTAGCACCAAAGCTCCGT
GGAAAGAACCTTTTCCCATCGAGC: GAAAGAACCTTTTCCCATCGAGCT
TTGAAACCGTCAGACTGGTCAGTG: TGAAACCGTCAGACTGGTCAGTGA
ATGGAAAGAACCTTTTCCCATCGA: TGGAAAGAACCTTTTCCCATCGAG
AATCCGGATGAATCTCTGCAGAGT: ATCCGGATGAATCTCTGCAGAGTC
CAAAGTCATTGTTAGGGATTCCAC: AAAGTCATTGTTAGGGATTCCACA
ATCTACAATACGCAAGGACACAAG: TCTACAATACGCAAGGACACAAGT
ACCCCATTCGCCTCTACCAAAATC: CCCCATTCGCCTCTACCAAAATCC
ACTTATTATTGCGTGGCATGCGTG: CTTATTATTGCGTGGCATGCGTGA
ATATGCTAACCTACTGCTGACATT: TATGCTAACCTACTGCTGACATTC
ACACACGAGTCCACGGTGCGCTAA: CACACGAGTCCACGGTGCGCTAAC
TGGTTGTCCTACTTCACCGGCTAG: GGTTGTCCTACTTCACCGGCTAGT
CTCAGTGTGAGGTTAAGCTTTTGC: TCAGTGTGAGGTTAAGCTTTTGCT
TGTTTACTATACTAGAGGGGCAAA: GTTTACTATACTAGAGGGGCAAAG
ACTTGGCAGCATAGCAAGGACTGT: CTTGGCAGCATAGCAAGGACTGTA
GCCGACTTCATCTACAATACGCAA: CCGACTTCATCTACAATACGCAAG
TACCGGGCAATAGTGACAAAGGGT: ACCGGGCAATAGTGACAAAGGGTT
CACTCCTACGATTATGCCTGGCCA: ACTCCTACGATTATGCCTGGCCAC
CGGAAGAACAGGATTAATCCATTG: GGAAGAACAGGATTAATCCATTGG
GGCCTCTTCCACTAACACACCTTG: GCCTCTTCCACTAACACACCTTGG
ACGGAACACTTAAACGGGCGGGTA: CGGAACACTTAAACGGGCGGGTAT
GACAGAGTTTTAGCCGAATGTTTC: ACAGAGTTTTAGCCGAATGTTTCT
AACAGGTGGATAAACTAAGCGGCT: ACAGGTGGATAAACTAAGCGGCTT
CCTCTTCCACTAACACACCTTGGT: CTCTTCCACTAACACACCTTGGTG
CGATGTTGGACGTTTCTCGCACGT: GATGTTGGACGTTTCTCGCACGTG
TGTCCAAAAGTTGTGCGTAAATGG: GTCCAAAAGTTGTGCGTAAATGGG
GGGACGAATCTAGCACCAAAGCTC: GGACGAATCTAGCACCAAAGCTCC
AGATGGTTGGATGCAGAAGGACCC: GATGGTTGGATGCAGAAGGACCCC
TGCACGTTTGTCCAATTCAATCGC: GCACGTTTGTCCAATTCAATCGCT
GGGTATTTCCTGTGGCCAAGTCCT: GGTATTTCCTGTGGCCAAGTCCTC
AACTAAGCGGCTTAGACTCTTGAA: ACTAAGCGGCTTAGACTCTTGAAG
CCAAAGTCATTGTTAGGGATTCCA: CAAAGTCATTGTTAGGGATTCCAC
GCGAACATGCCGATACGTCACATA: CGAACATGCCGATACGTCACATAC
ACTAACACTGTTTTTTTGCGAGTA: CTAACACTGTTTTTTTGCGAGTAT
GTCCCCGTACTGTCACATAATGGA: TCCCCGTACTGTCACATAATGGAT
GGAACACACGAGTCCACGGTGCGC: GAACACACGAGTCCACGGTGCGCT
CACGAGGGATATTGGTTGTCCTAC: ACGAGGGATATTGGTTGTCCTACT
AAAAAATGCCAGGTGTAGAGAATC: AAAAATGCCAGGTGTAGAGAATCA
ATAAACTAAGCGGCTTAGACTCTT: TAAACTAAGCGGCTTAGACTCTTG
GAATCGTGTAACACGCTGAAAAAA: AATCGTGTAACACGCTGAAAAAAA
GGATATTGGTTGTCCTACTTCACC: GATATTGGTTGTCCTACTTCACCG
TTTCCCCTCCCTCAGCCAGGTTGC: TTCCCCTCCCTCAGCCAGGTTGCG
GAATCTAGCACCAAAGCTCCGTAC: AATCTAGCACCAAAGCTCCGTACC
CACTTGATCCACAGGTTAGTGCAC: ACTTGATCCACAGGTTAGTGCACC
GGTGTCTCTCCGGCGCCACCGCCT: GTGTCTCTCCGGCGCCACCGCCTC
GTCACGTAAAAGACCTCAATATAA: TCACGTAAAAGACCTCAATATAAA
CATACTGACTTGCGCTTCGCGGAA: ATACTGACTTGCGCTTCGCGGAAG
GTTCAACTTGGCAGCATAGCAAGG: TTCAACTTGGCAGCATAGCAAGGA
TGGATCCAACCAGGTGACCCACGG: GGATCCAACCAGGTGACCCACGGT
GCCCGCTCAGGAACCCGTATTTCA: CCCGCTCAGGAACCCGTATTTCAG
CCACGGACAACCAGTTGTCTCAGG: CACGGACAACCAGTTGTCTCAGGT
TTGCACGCCACACTACCAACAGGG: TGCACGCCACACTACCAACAGGGC
GAGACTATAGAGGCCCGGCGTGAG: AGACTATAGAGGCCCGGCGTGAGC
AGCCCCAACAGGTGGATAAACTAA: GCCCCAACAGGTGGATAAACTAAG
TGCCATACATGTGGATACGTCTCT: GCCATACATGTGGATACGTCTCTA
GAGACTAACACTGTTTTTTTGCGA: AGACTAACACTGTTTTTTTGCGAG
TAACATCAGACCTGTTTCCGATAA: AACATCAGACCTGTTTCCGATAAG
GCGGGTATTTCCTGTGGCCAAGTC: CGGGTATTTCCTGTGGCCAAGTCC
TCAGTTTGTGACGCCCGCTCAGGA: CAGTTTGTGACGCCCGCTCAGGAA
TTCAGAGTCCGAGTATTAGCACGT: TCAGAGTCCGAGTATTAGCACGTG
AAATAGGAACACACGAGTCCACGG: AATAGGAACACACGAGTCCACGGT
CCACCGCCTCGTTGGCCTCTTCCA: CACCGCCTCGTTGGCCTCTTCCAC
AACATGCCGATACGTCACATACAA: ACATGCCGATACGTCACATACAAA
CTCAGGTAAATTGAGACTATAGAG: TCAGGTAAATTGAGACTATAGAGG
TGGTAGGTGTATGAATCGTGTAAC: GGTAGGTGTATGAATCGTGTAACA
CATACATGTGGATACGTCTCTAAT: ATACATGTGGATACGTCTCTAATA
CCCTCAGCCAGGTTGCGGCATAGA: CCTCAGCCAGGTTGCGGCATAGAT
ACAATACGCAAGGACACAAGTGGG: CAATACGCAAGGACACAAGTGGGC
TAATCAGACTGTTTAGGGCTTCGA: AATCAGACTGTTTAGGGCTTCGAC
CGTTTCTCGCACGTGCTGCTTTAT: GTTTCTCGCACGTGCTGCTTTATC
AGTTAGAAGAGACTAACACTGTTT: GTTAGAAGAGACTAACACTGTTTT
ACAAACATACTAGTGATAACCGAG: CAAACATACTAGTGATAACCGAGC
CACCATCAAAAGATAACACGCACA: ACCATCAAAAGATAACACGCACAT
GAGGTGTTCTTATAGTATTACTGG: AGGTGTTCTTATAGTATTACTGGT
TATACCTAAGCTTCAGAGTCCGAG: ATACCTAAGCTTCAGAGTCCGAGT
GGTATTATATGCTAACCTACTGCT: GTATTATATGCTAACCTACTGCTG
ACCGAGCCCCAACAGGTGGATAAA: CCGAGCCCCAACAGGTGGATAAAC
ACAGAATACCAGTACAGGTTCTGC: CAGAATACCAGTACAGGTTCTGCA
GTATTATATGCTAACCTACTGCTG: TATTATATGCTAACCTACTGCTGA
CTAAGCGGCTTAGACTCTTGAAGG: TAAGCGGCTTAGACTCTTGAAGGG
ATACTAGAGGGGCAAAGCACAGGC: TACTAGAGGGGCAAAGCACAGGCC
GTGTGTATGCATAAGCGGTTTGCT: TGTGTATGCATAAGCGGTTTGCTG
CCTCAATATAAACATTATGGATAT: CTCAATATAAACATTATGGATATT
TCTAGCTGCAGTTGGCGCCCATGA: CTAGCTGCAGTTGGCGCCCATGAG
ACCAAAGCTCCGTACCCCATTCGC: CCAAAGCTCCGTACCCCATTCGCC
AGAGGATCGTAGTGTAAAAACTCC: GAGGATCGTAGTGTAAAAACTCCA
TGTGACGCCCGCTCAGGAACCCGT: GTGACGCCCGCTCAGGAACCCGTA
TAACTACAATGCTGGAAAGTCCTT: AACTACAATGCTGGAAAGTCCTTT
CCTACTTCACCGGCTAGTTGCACG: CTACTTCACCGGCTAGTTGCACGC
GCGAGTATCAATGTTGACATCAAA: CGAGTATCAATGTTGACATCAAAC
ATAGCAAGGACTGTAGGCACGAGG: TAGCAAGGACTGTAGGCACGAGGG
GCTTCGACGCGCCTTACTGGTGTC: CTTCGACGCGCCTTACTGGTGTCT
TGCGCACGGTTAGAGGCATCTGCG: GCGCACGGTTAGAGGCATCTGCGT
AACTACAATGCTGGAAAGTCCTTT: ACTACAATGCTGGAAAGTCCTTTA
CAAAGGGTTGGGCAAATAACTACA: AAAGGGTTGGGCAAATAACTACAA
GTTAGAGGCATCTGCGTTCCTGAA: TTAGAGGCATCTGCGTTCCTGAAT
AGCACCAAAGCTCCGTACCCCATT: GCACCAAAGCTCCGTACCCCATTC
GGACCCCTTAGATCTAGCTGCAGT: GACCCCTTAGATCTAGCTGCAGTT
TGCCAGGTGTAGAGAATCAGTTGA: GCCAGGTGTAGAGAATCAGTTGAA
TCTCGTCAGTTTGTGACGCCCGCT: CTCGTCAGTTTGTGACGCCCGCTC
TAGAGGCATCTGCGTTCCTGAATG: AGAGGCATCTGCGTTCCTGAATGC
CTTCATCTACAATACGCAAGGACA: TTCATCTACAATACGCAAGGACAC
TAAGCTTCAGAGTCCGAGTATTAG: AAGCTTCAGAGTCCGAGTATTAGC
ATGCTGGAAAGTCCTTTATTTGCG: TGCTGGAAAGTCCTTTATTTGCGC
TCCCACATACTGACTTGCGCTTCG: CCCACATACTGACTTGCGCTTCGC
ATACTGACTTGCGCTTCGCGGAAG: TACTGACTTGCGCTTCGCGGAAGA
GGCGCCACCGCCTCGTTGGCCTCT: GCGCCACCGCCTCGTTGGCCTCTT
ATGCGTGACCTTGTAAGAGTTGGG: TGCGTGACCTTGTAAGAGTTGGGA
CCTTGTAAGAGTTGGGACGAATCT: CTTGTAAGAGTTGGGACGAATCTA
TCTGAGCCATGACTTACAATGCGA: CTGAGCCATGACTTACAATGCGAA
GCATAGCAAGGACTGTAGGCACGA: CATAGCAAGGACTGTAGGCACGAG
TCGGCGGGTTGTTAACTTAACAGA: CGGCGGGTTGTTAACTTAACAGAC
ATTGCGTGGCATGCGTGACCTTGT: TTGCGTGGCATGCGTGACCTTGTA
TTTTGCGAGTATCAATGTTGACAT: TTTGCGAGTATCAATGTTGACATC
CAGTACAGGTTCTGCAGAAGTATA: AGTACAGGTTCTGCAGAAGTATAG
TCCAACCTGTCACGTAAAAGACCT: CCAACCTGTCACGTAAAAGACCTC
TACTCTCCACTTATTATTGCGTGG: ACTCTCCACTTATTATTGCGTGGC
GTGCACCTAACCTTTTCACAAATA: TGCACCTAACCTTTTCACAAATAA
TGTCTCAGGTAAATTGAGACTATA: GTCTCAGGTAAATTGAGACTATAG
CTTAGGTATTATATGCTAACCTAC: TTAGGTATTATATGCTAACCTACT
GACTGTTTAGGGCTTCGACGCGCC: ACTGTTTAGGGCTTCGACGCGCCT
TCCGCCAGATATTCCCGACTATTC: CCGCCAGATATTCCCGACTATTCG
TTGGTTGTCCTACTTCACCGGCTA: TGGTTGTCCTACTTCACCGGCTAG
ATTTACGCTTAGGTATTATATGCT: TTTACGCTTAGGTATTATATGCTA
CTCTGCAGAGTCAGTAGCCTCTAT: TCTGCAGAGTCAGTAGCCTCTATA
ACCCGTATTTCAGTAGAAATAGGA: CCCGTATTTCAGTAGAAATAGGAA
CTTGAAGGGCAACGACGCGCCATG: TTGAAGGGCAACGACGCGCCATGG
TCTGCGTGTCCAAAAGTTGTGCGT: CTGCGTGTCCAAAAGTTGTGCGTA
CATACTAGTGATAACCGAGCCCCA: ATACTAGTGATAACCGAGCCCCAA
ATCCCATAACATCAGACCTGTTTC: TCCCATAACATCAGACCTGTTTCC
GGGAGGTGTTCTTATAGTATTACT: GGAGGTGTTCTTATAGTATTACTG
TAGCTGACAATGTCACTTCGGTCC: AGCTGACAATGTCACTTCGGTCCG
CAACCAAAGTCATTGTTAGGGATT: AACCAAAGTCATTGTTAGGGATTC
GGCAGCAATGCTCACTCGGTAAGT: GCAGCAATGCTCACTCGGTAAGTA
ACTGGTATACTCTCCACTTATTAT: CTGGTATACTCTCCACTTATTATT
CTAATACCCTCGGAGGCCCAGCCG: TAATACCCTCGGAGGCCCAGCCGT
TAGAAGAGACTAACACTGTTTTTT: AGAAGAGACTAACACTGTTTTTTT
GGGGCAAAGCACAGGCCGAGAGGA: GGGCAAAGCACAGGCCGAGAGGAT
TTCTGCAGAAGTATAGCTGACAAT: TCTGCAGAAGTATAGCTGACAATG
ATCCGGCCCGTCAGCGTTCAGTTA: TCCGGCCCGTCAGCGTTCAGTTAG
TTAAGCTTTTGCTGGTGTTTCTTG: TAAGCTTTTGCTGGTGTTTCTTGG
GCCAAGTCCTCTCTCGTCAGTTTG: CCAAGTCCTCTCTCGTCAGTTTGT
GAACACACGAGTCCACGGTGCGCT: AACACACGAGTCCACGGTGCGCTA
GGTCCGAGGCAGCAATGCTCACTC: GTCCGAGGCAGCAATGCTCACTCG
ATGTGTTTGTGTAGCTCAGATATT: TGTGTTTGTGTAGCTCAGATATTT
CTTAGACTCTTGAAGGGCAACGAC: TTAGACTCTTGAAGGGCAACGACG
CATGTGTTTGTGTAGCTCAGATAT: ATGTGTTTGTGTAGCTCAGATATT
AAGTTAAGCGATTTTACTTATCTG: AGTTAAGCGATTTTACTTATCTGA
CCGGATGAATCTCTGCAGAGTCAG: CGGATGAATCTCTGCAGAGTCAGT
TACGTTAACTTGGTAGGTGTATGA: ACGTTAACTTGGTAGGTGTATGAA
CACTTCGGTCCGAGGCAGCAATGC: ACTTCGGTCCGAGGCAGCAATGCT
ACAAGTGGGCGCTTCTGCTATACA: CAAGTGGGCGCTTCTGCTATACAG
ACGCACATGTTTACTATACTAGAG: CGCACATGTTTACTATACTAGAGG
CGTACTGTCACATAATGGATCCAA: GTACTGTCACATAATGGATCCAAC
GACCCCTTAGATCTAGCTGCAGTT: ACCCCTTAGATCTAGCTGCAGTTG
GTTGAAACCGTCAGACTGGTCAGT: TTGAAACCGTCAGACTGGTCAGTG
CCCAACAGGTGGATAAACTAAGCG: CCAACAGGTGGATAAACTAAGCGG
CCTCAGCCAGGTTGCGGCATAGAT: CTCAGCCAGGTTGCGGCATAGATG
ACGGTTAGAGGCATCTGCGTTCCT: CGGTTAGAGGCATCTGCGTTCCTG
GTCTCTAATACCCTCGGAGGCCCA: TCTCTAATACCCTCGGAGGCCCAG
ACACGCACATGTTTACTATACTAG: CACGCACATGTTTACTATACTAGA
TGATTTACGCTTAGGTATTATATG: GATTTACGCTTAGGTATTATATGC
ATGAATCTCTGCAGAGTCAGTAGC: TGAATCTCTGCAGAGTCAGTAGCC
AAAATGCCAGGTGTAGAGAATCAG: AAATGCCAGGTGTAGAGAATCAGT
CGGATGAATCTCTGCAGAGTCAGT: GGATGAATCTCTGCAGAGTCAGTA
CTAACGGTGATGCATGGACAGAGT: TAACGGTGATGCATGGACAGAGTT
CTTGGTGCAGGACCTCAGTGTGAG: TTGGTGCAGGACCTCAGTGTGAGG
TACAATGCGAACCTTGCCATACAT: ACAATGCGAACCTTGCCATACATG
AGCACGTATTCCTCTCATGTTGCA: GCACGTATTCCTCTCATGTTGCAC
ATAGTATTACTGGTATACTCTCCA: TAGTATTACTGGTATACTCTCCAC
GTCATTGTTAGGGATTCCACACTC: TCATTGTTAGGGATTCCACACTCC
ACATAATGGATCCAACCAGGTGAC: CATAATGGATCCAACCAGGTGACC
GTGGATAAACTAAGCGGCTTAGAC: TGGATAAACTAAGCGGCTTAGACT
TACCGGCGAACATGCCGATACGTC: ACCGGCGAACATGCCGATACGTCA
TTGCGTGGCATGCGTGACCTTGTA: TGCGTGGCATGCGTGACCTTGTAA
ATTCCTCTCATGTTGCACGTTTGT: TTCCTCTCATGTTGCACGTTTGTC
GCACGTGGGAAAATACCGGGCAAT: CACGTGGGAAAATACCGGGCAATA
AATCGCTACTTTGTCCACGAATCT: ATCGCTACTTTGTCCACGAATCTT
ACCAAAATCCTTCCACGGACAACC: CCAAAATCCTTCCACGGACAACCA
GTCCAAAAGTTGTGCGTAAATGGG: TCCAAAAGTTGTGCGTAAATGGGT
CTCACTTGATCCACAGGTTAGTGC: TCACTTGATCCACAGGTTAGTGCA
AAAAGACCTCAATATAAACATTAT: AAAGACCTCAATATAAACATTATG
CTAACACTGTTTTTTTGCGAGTAT: TAACACTGTTTTTTTGCGAGTATC
CTACTGCTGACATTCCCCCGTGCG: TACTGCTGACATTCCCCCGTGCGG
CAGTAGCCTCTATACAGTGATTTA: AGTAGCCTCTATACAGTGATTTAC
CTATACTAGAGGGGCAAAGCACAG: TATACTAGAGGGGCAAAGCACAGG
CGGCCCGTCAGCGTTCAGTTAGAA: GGCCCGTCAGCGTTCAGTTAGAAG
TGCGGCCGTCTGCGTGTCCAAAAG: GCGGCCGTCTGCGTGTCCAAAAGT
CCTTGCCATACATGTGGATACGTC: CTTGCCATACATGTGGATACGTCT
AAAAAAATGCCAGGTGTAGAGAAT: AAAAAATGCCAGGTGTAGAGAATC
TTCCACACTCCTACGATTATGCCT: TCCACACTCCTACGATTATGCCTG
AGCACATTGTACGATGTTGGACGT: GCACATTGTACGATGTTGGACGTT
CGTAGCATGGAAAGAACCTTTTCC: GTAGCATGGAAAGAACCTTTTCCC
GTAGCATGGAAAGAACCTTTTCCC: TAGCATGGAAAGAACCTTTTCCCA
GGCCCGGCGTGAGCACGTATTCCT: GCCCGGCGTGAGCACGTATTCCTC
ACGTGGGAAAATACCGGGCAATAG: CGTGGGAAAATACCGGGCAATAGT
TGACCCACGGTGTGTATGCATAAG: GACCCACGGTGTGTATGCATAAGC
GGTGTTCTTATAGTATTACTGGTA: GTGTTCTTATAGTATTACTGGTAT
GCTTCAGAGTCCGAGTATTAGCAC: CTTCAGAGTCCGAGTATTAGCACG
GCAGGACCTCAGTGTGAGGTTAAG: CAGGACCTCAGTGTGAGGTTAAGC
ACATTATACCTAAGCTTCAGAGTC: CATTATACCTAAGCTTCAGAGTCC
CTGCGTGTCCAAAAGTTGTGCGTA: TGCGTGTCCAAAAGTTGTGCGTAA
TATGCATAAGCGGTTTGCTGGCTT: ATGCATAAGCGGTTTGCTGGCTTG
GAGTTTTAGCCGAATGTTTCTCAC: AGTTTTAGCCGAATGTTTCTCACT
AACCGAGCCCCAACAGGTGGATAA: ACCGAGCCCCAACAGGTGGATAAA
TGTCCTACTTCACCGGCTAGTTGC: GTCCTACTTCACCGGCTAGTTGCA
TGGACGTTTCTCGCACGTGCTGCT: GGACGTTTCTCGCACGTGCTGCTT
CCAACCTGTCACGTAAAAGACCTC: CAACCTGTCACGTAAAAGACCTCA
CTTAACAAGTTAAGCGATTTTACT: TTAACAAGTTAAGCGATTTTACTT
AGAGTCCGAGTATTAGCACGTGGG: GAGTCCGAGTATTAGCACGTGGGA
ATTTTACTTATCTGAGCCATGACT: TTTTACTTATCTGAGCCATGACTT
GGGCAATAGTGACAAAGGGTTGGG: GGCAATAGTGACAAAGGGTTGGGC
ATACTCTCCACTTATTATTGCGTG: TACTCTCCACTTATTATTGCGTGG
TGCGCCGACTTCATCTACAATACG: GCGCCGACTTCATCTACAATACGC
TGATAACCGAGCCCCAACAGGTGG: GATAACCGAGCCCCAACAGGTGGA
CCCTCGGAGGCCCAGCCGTGTGAA: CCTCGGAGGCCCAGCCGTGTGAAA
GCTTGGGCAAGGCAACATTATACC: CTTGGGCAAGGCAACATTATACCT
CCTTAACAAGTTAAGCGATTTTAC: CTTAACAAGTTAAGCGATTTTACT
GGTGTCCCACATACTGACTTGCGC: GTGTCCCACATACTGACTTGCGCT
GGTTGTTAACTTAACAGACGCAGA: GTTGTTAACTTAACAGACGCAGAT
GAATACCAGTACAGGTTCTGCAGA: AATACCAGTACAGGTTCTGCAGAA
CGTGGCATGCGTGACCTTGTAAGA: GTGGCATGCGTGACCTTGTAAGAG
GAGCCCTCGGATCCCATAACATCA: AGCCCTCGGATCCCATAACATCAG
AGCGTGGCACTCTCGTCCTTAACA: GCGTGGCACTCTCGTCCTTAACAA
GATTATGCCTGGCCACTTCTGAGC: ATTATGCCTGGCCACTTCTGAGCC
TCCCGACTATTCGGTACAGAATAC: CCCGACTATTCGGTACAGAATACC
TGCAGTTCCTAATCAGACTGTTTA: GCAGTTCCTAATCAGACTGTTTAG
AGCTTTTGCTGGTGTTTCTTGGAT: GCTTTTGCTGGTGTTTCTTGGATC
GGCGACCCGTTCCAACCTGTCACG: GCGACCCGTTCCAACCTGTCACGT
AGACCTGTTTCCGATAAGGTGCAC: GACCTGTTTCCGATAAGGTGCACC
AAATTGAGACTATAGAGGCCCGGC: AATTGAGACTATAGAGGCCCGGCG
GACAAAGGGTTGGGCAAATAACTA: ACAAAGGGTTGGGCAAATAACTAC
TCATCGTGTCGTGCGCCCCCTAGG: CATCGTGTCGTGCGCCCCCTAGGT
TATTATTGCGTGGCATGCGTGACC: ATTATTGCGTGGCATGCGTGACCT
TTGTCCACGAATCTTTCCCCTCCC: TGTCCACGAATCTTTCCCCTCCCT
CTCTACCAAAATCCTTCCACGGAC: TCTACCAAAATCCTTCCACGGACA
GATCGTGCGCCGACTTCATCTACA: ATCGTGCGCCGACTTCATCTACAA
TACAGGTTCTGCAGAAGTATAGCT: ACAGGTTCTGCAGAAGTATAGCTG
GAACCTTTTCCCATCGAGCTGTTC: AACCTTTTCCCATCGAGCTGTTCA
TCCTACGATTATGCCTGGCCACTT: CCTACGATTATGCCTGGCCACTTC
TAACAGACGCAGATACCGGCGAAC: AACAGACGCAGATACCGGCGAACA
CTTGATCCACAGGTTAGTGCACCA: TTGATCCACAGGTTAGTGCACCAT
CATTCGCCTCTACCAAAATCCTTC: ATTCGCCTCTACCAAAATCCTTCC
TTTCCGATAAGGTGCACCTAACCT: TTCCGATAAGGTGCACCTAACCTT
CCCTCCCTCAGCCAGGTTGCGGCA: CCTCCCTCAGCCAGGTTGCGGCAT
CATAGCAAGGACTGTAGGCACGAG: ATAGCAAGGACTGTAGGCACGAGG
ATGACTTACAATGCGAACCTTGCC: TGACTTACAATGCGAACCTTGCCA
ATGCGAACCTTGCCATACATGTGG: TGCGAACCTTGCCATACATGTGGA
TTTCAGTAGAAATAGGAACACACG: TTCAGTAGAAATAGGAACACACGA
TCCTGAATGCAGTTCCTAATCAGA: CCTGAATGCAGTTCCTAATCAGAC
GAAACGGAACACTTAAACGGGCGG: AAACGGAACACTTAAACGGGCGGG
AGGGCTTCGACGCGCCTTACTGGT: GGGCTTCGACGCGCCTTACTGGTG
ATACGTCTCTAATACCCTCGGAGG: TACGTCTCTAATACCCTCGGAGGC
TGCGCTGAATCGTTTTCGTAGCAT: GCGCTGAATCGTTTTCGTAGCATG
TCAACTTGGCAGCATAGCAAGGAC: CAACTTGGCAGCATAGCAAGGACT
TGTTAACTTAACAGACGCAGATAC: GTTAACTTAACAGACGCAGATACC
ACATACAAACATACTAGTGATAAC: CATACAAACATACTAGTGATAACC
CCCCCGTGCGGCCGTCTGCGTGTC: CCCCGTGCGGCCGTCTGCGTGTCC
TGAAAAAAATGCCAGGTGTAGAGA: GAAAAAAATGCCAGGTGTAGAGAA
CACGTGCTGCTTTATCCGGCCCGT: ACGTGCTGCTTTATCCGGCCCGTC
GACCCACGGTGTGTATGCATAAGC: ACCCACGGTGTGTATGCATAAGCG
GTTAAGCTTTTGCTGGTGTTTCTT: TTAAGCTTTTGCTGGTGTTTCTTG
ACAACCAAAGTCATTGTTAGGGAT: CAACCAAAGTCATTGTTAGGGATT
CCCATCGAGCTGTTCAACTTGGCA: CCATCGAGCTGTTCAACTTGGCAG
CAAATAATTCATCGTGTCGTGCGC: AAATAATTCATCGTGTCGTGCGCC
AAGGCGGTCACTGCACAATGATGG: AGGCGGTCACTGCACAATGATGGC
AACCTTTTCCCATCGAGCTGTTCA: ACCTTTTCCCATCGAGCTGTTCAA
AATATAAACATTATGGATATTCCG: ATATAAACATTATGGATATTCCGC
GGCGGGTATTTCCTGTGGCCAAGT: GCGGGTATTTCCTGTGGCCAAGTC
CGAGCTGTTCAACTTGGCAGCATA: GAGCTGTTCAACTTGGCAGCATAG
TAAACTAAGCGGCTTAGACTCTTG: AAACTAAGCGGCTTAGACTCTTGA
TGGAAAGAACCTTTTCCCATCGAG: GGAAAGAACCTTTTCCCATCGAGC
AAGAGTTGGGACGAATCTAGCACC: AGAGTTGGGACGAATCTAGCACCA
GTTAGGGATTCCACACTCCTACGA: TTAGGGATTCCACACTCCTACGAT
TGCACCTAACCTTTTCACAAATAA: GCACCTAACCTTTTCACAAATAAT
TGGTGTTTCTTGGATCGTGCGCCG: GGTGTTTCTTGGATCGTGCGCCGA
CTAGTGATAACCGAGCCCCAACAG: TAGTGATAACCGAGCCCCAACAGG
AGCCAGGTTGCGGCATAGATGGTT: GCCAGGTTGCGGCATAGATGGTTG
CTTCGACGCGCCTTACTGGTGTCT: TTCGACGCGCCTTACTGGTGTCTC
GGCAAATAACTACAATGCTGGAAA: GCAAATAACTACAATGCTGGAAAG
CTGGTCAGTGAAACGGAACACTTA: TGGTCAGTGAAACGGAACACTTAA
GTTGCACGTTTGTCCAATTCAATC: TTGCACGTTTGTCCAATTCAATCG
GCAGAGTCAGTAGCCTCTATACAG: CAGAGTCAGTAGCCTCTATACAGT
TTCCACGGACAACCAGTTGTCTCA: TCCACGGACAACCAGTTGTCTCAG
AAGATAACACGCACATGTTTACTA: AGATAACACGCACATGTTTACTAT
GTGTAAAAACTCCACAACCAAAGT: TGTAAAAACTCCACAACCAAAGTC
TAGTGACAAAGGGTTGGGCAAATA: AGTGACAAAGGGTTGGGCAAATAA
TTAGAAGAGACTAACACTGTTTTT: TAGAAGAGACTAACACTGTTTTTT
ATTGAGACTATAGAGGCCCGGCGT: TTGAGACTATAGAGGCCCGGCGTG
ACTTTGTCCACGAATCTTTCCCCT: CTTTGTCCACGAATCTTTCCCCTC
AATGGGTTAGGGAGGTGTTCTTAT: ATGGGTTAGGGAGGTGTTCTTATA
TATGCCTGGCCACTTCTGAGCCCT: ATGCCTGGCCACTTCTGAGCCCTC
GCCTCTACCAAAATCCTTCCACGG: CCTCTACCAAAATCCTTCCACGGA
TTTCGTAGCATGGAAAGAACCTTT: TTCGTAGCATGGAAAGAACCTTTT
CGAGTTGAAACCGTCAGACTGGTC: GAGTTGAAACCGTCAGACTGGTCA
TCCTCTCATGTTGCACGTTTGTCC: CCTCTCATGTTGCACGTTTGTCCA
CACAGACTTGCTGAGGACCCGAGG: ACAGACTTGCTGAGGACCCGAGGA
AACACACCTTGGTGCAGGACCTCA: ACACACCTTGGTGCAGGACCTCAG
CACGCCACACTACCAACAGGGCGA: ACGCCACACTACCAACAGGGCGAA
GTGATTTACGCTTAGGTATTATAT: TGATTTACGCTTAGGTATTATATG
TCCTTTATTTGCGCACGGTTAGAG: CCTTTATTTGCGCACGGTTAGAGG
TCGGTAAGTAAGCGTGGCACTCTC: CGGTAAGTAAGCGTGGCACTCTCG
TCCTTCCACGGACAACCAGTTGTC: CCTTCCACGGACAACCAGTTGTCT
CCACATACTGACTTGCGCTTCGCG: CACATACTGACTTGCGCTTCGCGG
TTTACTATACTAGAGGGGCAAAGC: TTACTATACTAGAGGGGCAAAGCA
CACAGGTTAGTGCACCATCAAAAG: ACAGGTTAGTGCACCATCAAAAGA
TAGCCTCTATACAGTGATTTACGC: AGCCTCTATACAGTGATTTACGCT
GATCCCATAACATCAGACCTGTTT: ATCCCATAACATCAGACCTGTTTC
AAAGTTGTGCGTAAATGGGTTAGG: AAGTTGTGCGTAAATGGGTTAGGG
TAGGTGTATGAATCGTGTAACACG: AGGTGTATGAATCGTGTAACACGC
ACCTTTTCCCATCGAGCTGTTCAA: CCTTTTCCCATCGAGCTGTTCAAC
TCTACCAAAATCCTTCCACGGACA: CTACCAAAATCCTTCCACGGACAA
TTTTAGCCGAATGTTTCTCACTTG: TTTAGCCGAATGTTTCTCACTTGA
CGTGCGCCGACTTCATCTACAATA: GTGCGCCGACTTCATCTACAATAC
CTCCGGCGCCACCGCCTCGTTGGC: TCCGGCGCCACCGCCTCGTTGGCC
CAGAGTCCGAGTATTAGCACGTGG: AGAGTCCGAGTATTAGCACGTGGG
ACCTGTCACGTAAAAGACCTCAAT: CCTGTCACGTAAAAGACCTCAATA
TAGCAAGGACTGTAGGCACGAGGG: AGCAAGGACTGTAGGCACGAGGGA
CCGGGCAATAGTGACAAAGGGTTG: CGGGCAATAGTGACAAAGGGTTGG
TTCCGATAAGGTGCACCTAACCTT: TCCGATAAGGTGCACCTAACCTTT
GGATCCAACCAGGTGACCCACGGT: GATCCAACCAGGTGACCCACGGTG
CCGTGTGAAAAAAGTACGTTAACT: CGTGTGAAAAAAGTACGTTAACTT
TTCCTGTGGCCAAGTCCTCTCTCG: TCCTGTGGCCAAGTCCTCTCTCGT
CAGAGTTTTAGCCGAATGTTTCTC: AGAGTTTTAGCCGAATGTTTCTCA
TTGGATGCAGAAGGACCCCTTAGA: TGGATGCAGAAGGACCCCTTAGAT
AACATACTAGTGATAACCGAGCCC: ACATACTAGTGATAACCGAGCCCC
TGCAGTTGGCGCCCATGAGCACCG: GCAGTTGGCGCCCATGAGCACCGG
GGTCCCCGTACTGTCACATAATGG: GTCCCCGTACTGTCACATAATGGA
TTACGCTTAGGTATTATATGCTAA: TACGCTTAGGTATTATATGCTAAC
GTGACCCACGGTGTGTATGCATAA: TGACCCACGGTGTGTATGCATAAG
TTCCCATCGAGCTGTTCAACTTGG: TCCCATCGAGCTGTTCAACTTGGC
GTCACATAATGGATCCAACCAGGT: TCACATAATGGATCCAACCAGGTG
AACACTTAAACGGGCGGGTATTTC: ACACTTAAACGGGCGGGTATTTCC
TCTTCCACTAACACACCTTGGTGC: CTTCCACTAACACACCTTGGTGCA
TCATGTTGCACGTTTGTCCAATTC: CATGTTGCACGTTTGTCCAATTCA
TGGCCACTTCTGAGCCCTCGGATC: GGCCACTTCTGAGCCCTCGGATCC
TCTCCGGCGCCACCGCCTCGTTGG: CTCCGGCGCCACCGCCTCGTTGGC
ACGTCTCTAATACCCTCGGAGGCC: CGTCTCTAATACCCTCGGAGGCCC
CCGTCAGACTGGTCAGTGAAACGG: CGTCAGACTGGTCAGTGAAACGGA
TGGCGACCCGTTCCAACCTGTCAC: GGCGACCCGTTCCAACCTGTCACG
TCTGCGTTCCTGAATGCAGTTCCT: CTGCGTTCCTGAATGCAGTTCCTA
CTCTATACAGTGATTTACGCTTAG: TCTATACAGTGATTTACGCTTAGG
GAATGTTTCTCACTTGATCCACAG: AATGTTTCTCACTTGATCCACAGG
CGTGCTGCTTTATCCGGCCCGTCA: GTGCTGCTTTATCCGGCCCGTCAG
GGCCCAGCCGTGTGAAAAAAGTAC: GCCCAGCCGTGTGAAAAAAGTACG
TATGAATCGTGTAACACGCTGAAA: ATGAATCGTGTAACACGCTGAAAA
AAACGGAACACTTAAACGGGCGGG: AACGGAACACTTAAACGGGCGGGT
CGCACATGTTTACTATACTAGAGG: GCACATGTTTACTATACTAGAGGG
CTTGCGCTTCGCGGAAGAACAGGA: TTGCGCTTCGCGGAAGAACAGGAT
TGACCTTGTAAGAGTTGGGACGAA: GACCTTGTAAGAGTTGGGACGAAT
TGTCTCTCCGGCGCCACCGCCTCG: GTCTCTCCGGCGCCACCGCCTCGT
AACACACGAGTCCACGGTGCGCTA: ACACACGAGTCCACGGTGCGCTAA
AACAGGGCGAACATGTGTTTGTGT: ACAGGGCGAACATGTGTTTGTGTA
GTATTAGCACGTGGGAAAATACCG: TATTAGCACGTGGGAAAATACCGG
GAGTATCAATGTTGACATCAAACG: AGTATCAATGTTGACATCAAACGT
ACCCCTTAGATCTAGCTGCAGTTG: CCCCTTAGATCTAGCTGCAGTTGG
CTGAATCGTTTTCGTAGCATGGAA: TGAATCGTTTTCGTAGCATGGAAA
TGCAGAAGGACCCCTTAGATCTAG: GCAGAAGGACCCCTTAGATCTAGC
GTCAGCGTTCAGTTAGAAGAGACT: TCAGCGTTCAGTTAGAAGAGACTA
ATAATGGATCCAACCAGGTGACCC: TAATGGATCCAACCAGGTGACCCA
AGAGACTAACACTGTTTTTTTGCG: GAGACTAACACTGTTTTTTTGCGA
CACAAATAATTCATCGTGTCGTGC: ACAAATAATTCATCGTGTCGTGCG
AAAAACTCCACAACCAAAGTCATT: AAAACTCCACAACCAAAGTCATTG
CAATGTTGACATCAAACGTTATGC: AATGTTGACATCAAACGTTATGCG
AAAGCACAGGCCGAGAGGATCGTA: AAGCACAGGCCGAGAGGATCGTAG
AAACTAAGCGGCTTAGACTCTTGA: AACTAAGCGGCTTAGACTCTTGAA
CGTATTTCAGTAGAAATAGGAACA: GTATTTCAGTAGAAATAGGAACAC
TTATTGCGTGGCATGCGTGACCTT: TATTGCGTGGCATGCGTGACCTTG
GGGCTTCGACGCGCCTTACTGGTG: GGCTTCGACGCGCCTTACTGGTGT
CTCAATATAAACATTATGGATATT: TCAATATAAACATTATGGATATTC
GCGCCCATGAGCACCGGTCCCCGT: CGCCCATGAGCACCGGTCCCCGTA
TTATAGTATTACTGGTATACTCTC: TATAGTATTACTGGTATACTCTCC
CGTGCGGCCGTCTGCGTGTCCAAA: GTGCGGCCGTCTGCGTGTCCAAAA
TAAGCGGCTTAGACTCTTGAAGGG: AAGCGGCTTAGACTCTTGAAGGGC
CATACAAACATACTAGTGATAACC: ATACAAACATACTAGTGATAACCG
GTGCGTAAATGGGTTAGGGAGGTG: TGCGTAAATGGGTTAGGGAGGTGT
TAACCGAGCCCCAACAGGTGGATA: AACCGAGCCCCAACAGGTGGATAA
TCCGTACCCCATTCGCCTCTACCA: CCGTACCCCATTCGCCTCTACCAA
ACCTTTTCACAAATAATTCATCGT: CCTTTTCACAAATAATTCATCGTG
AGACTGGTCAGTGAAACGGAACAC: GACTGGTCAGTGAAACGGAACACT
CCCATTCGCCTCTACCAAAATCCT: CCATTCGCCTCTACCAAAATCCTT
GTAAGGCGGTCACTGCACAATGAT: TAAGGCGGTCACTGCACAATGATG
GCACGTTTGTCCAATTCAATCGCT: CACGTTTGTCCAATTCAATCGCTA
AGGACCCGAGGAATCCGGATGAAT: GGACCCGAGGAATCCGGATGAATC
TAGGTAAGGCGGTCACTGCACAAT: AGGTAAGGCGGTCACTGCACAATG
CTGAAAAAAATGCCAGGTGTAGAG: TGAAAAAAATGCCAGGTGTAGAGA
CTTGGTAGGTGTATGAATCGTGTA: TTGGTAGGTGTATGAATCGTGTAA
CTGAATGCAGTTCCTAATCAGACT: TGAATGCAGTTCCTAATCAGACTG
TATATGCTAACCTACTGCTGACAT: ATATGCTAACCTACTGCTGACATT
TGGCCAAGTCCTCTCTCGTCAGTT: GGCCAAGTCCTCTCTCGTCAGTTT
CTGCTATACAGGTGTCCCACATAC: TGCTATACAGGTGTCCCACATACT
ATTGTACGATGTTGGACGTTTCTC: TTGTACGATGTTGGACGTTTCTCG
AGTGCACCATCAAAAGATAACACG: GTGCACCATCAAAAGATAACACGC
TATTTGCGCACGGTTAGAGGCATC: ATTTGCGCACGGTTAGAGGCATCT
TTTCTCACTTGATCCACAGGTTAG: TTCTCACTTGATCCACAGGTTAGT
GTGTAGAGAATCAGTTGAACGTTG: TGTAGAGAATCAGTTGAACGTTGA
GGCTTAGACTCTTGAAGGGCAACG: GCTTAGACTCTTGAAGGGCAACGA
TGAAAAAAGTACGTTAACTTGGTA: GAAAAAAGTACGTTAACTTGGTAG
CGCACGTGCTGCTTTATCCGGCCC: GCACGTGCTGCTTTATCCGGCCCG
TCTCATGTTGCACGTTTGTCCAAT: CTCATGTTGCACGTTTGTCCAATT
CACTGCACAATGATGGCGACCCGT: ACTGCACAATGATGGCGACCCGTT
CGCGCCTTACTGGTGTCTCTCCGG: GCGCCTTACTGGTGTCTCTCCGGC
GATACGTCACATACAAACATACTA: ATACGTCACATACAAACATACTAG
ATGGATATTCCGCCAGATATTCCC: TGGATATTCCGCCAGATATTCCCG
GGATAAACTAAGCGGCTTAGACTC: GATAAACTAAGCGGCTTAGACTCT
ACGCCCGCTCAGGAACCCGTATTT: CGCCCGCTCAGGAACCCGTATTTC
AATACGCAAGGACACAAGTGGGCG: ATACGCAAGGACACAAGTGGGCGC
CTCTCCACTTATTATTGCGTGGCA: TCTCCACTTATTATTGCGTGGCAT
ACAATGCTGGAAAGTCCTTTATTT: CAATGCTGGAAAGTCCTTTATTTG
GCGCCGACTTCATCTACAATACGC: CGCCGACTTCATCTACAATACGCA
CGGTTTGCTGGCTTGGGCAAGGCA: GGTTTGCTGGCTTGGGCAAGGCAA
GCTTTATCCGGCCCGTCAGCGTTC: CTTTATCCGGCCCGTCAGCGTTCA
ACCTAACCTTTTCACAAATAATTC: CCTAACCTTTTCACAAATAATTCA
GTGTATGCATAAGCGGTTTGCTGG: TGTATGCATAAGCGGTTTGCTGGC
AACCTTGCCATACATGTGGATACG: ACCTTGCCATACATGTGGATACGT
CAGGGCGAACATGTGTTTGTGTAG: AGGGCGAACATGTGTTTGTGTAGC
CTGCTTTATCCGGCCCGTCAGCGT: TGCTTTATCCGGCCCGTCAGCGTT
ACAGACGCAGATACCGGCGAACAT: CAGACGCAGATACCGGCGAACATG
CTCTAATACCCTCGGAGGCCCAGC: TCTAATACCCTCGGAGGCCCAGCC
GCAACGACGCGCCATGGAGCACAC: CAACGACGCGCCATGGAGCACACA
TGCTGACATTCCCCCGTGCGGCCG: GCTGACATTCCCCCGTGCGGCCGT
GGTTTGCTGGCTTGGGCAAGGCAA: GTTTGCTGGCTTGGGCAAGGCAAC
AACCTACTGCTGACATTCCCCCGT: ACCTACTGCTGACATTCCCCCGTG
TTCGCGGAAGAACAGGATTAATCC: TCGCGGAAGAACAGGATTAATCCA
CCTCCCTCAGCCAGGTTGCGGCAT: CTCCCTCAGCCAGGTTGCGGCATA
GCTAACGGTGATGCATGGACAGAG: CTAACGGTGATGCATGGACAGAGT
AAATAATTCATCGTGTCGTGCGCC: AATAATTCATCGTGTCGTGCGCCC
CTCTTCCACTAACACACCTTGGTG: TCTTCCACTAACACACCTTGGTGC
TCTCTAATACCCTCGGAGGCCCAG: CTCTAATACCCTCGGAGGCCCAGC
TCTGCTATACAGGTGTCCCACATA: CTGCTATACAGGTGTCCCACATAC
AAACATACTAGTGATAACCGAGCC: AACATACTAGTGATAACCGAGCCC
TCGCTACTTTGTCCACGAATCTTT: CGCTACTTTGTCCACGAATCTTTC
TTGTGACGCCCGCTCAGGAACCCG: TGTGACGCCCGCTCAGGAACCCGT
ACGTAAAAGACCTCAATATAAACA: CGTAAAAGACCTCAATATAAACAT
TACTGGTGTCTCTCCGGCGCCACC: ACTGGTGTCTCTCCGGCGCCACCG
CGTTATGCGCTGAATCGTTTTCGT: GTTATGCGCTGAATCGTTTTCGTA
AGTGACAAAGGGTTGGGCAAATAA: GTGACAAAGGGTTGGGCAAATAAC
CGGCTTAGACTCTTGAAGGGCAAC: GGCTTAGACTCTTGAAGGGCAACG
AATGGATCCAACCAGGTGACCCAC: ATGGATCCAACCAGGTGACCCACG
AGTTAAGCGATTTTACTTATCTGA: GTTAAGCGATTTTACTTATCTGAG
TCACCGGCTAGTTGCACGCCACAC: CACCGGCTAGTTGCACGCCACACT
ATCGTGTCGTGCGCCCCCTAGGTA: TCGTGTCGTGCGCCCCCTAGGTAA
TGTCGTGCGCCCCCTAGGTAAGGC: GTCGTGCGCCCCCTAGGTAAGGCG
GTGTTTCTTGGATCGTGCGCCGAC: TGTTTCTTGGATCGTGCGCCGACT
TTGTACGATGTTGGACGTTTCTCG: TGTACGATGTTGGACGTTTCTCGC
AGTGTAAAAACTCCACAACCAAAG: GTGTAAAAACTCCACAACCAAAGT
GTTTGCTGGCTTGGGCAAGGCAAC: TTTGCTGGCTTGGGCAAGGCAACA
TTCTGCTATACAGGTGTCCCACAT: TCTGCTATACAGGTGTCCCACATA
GCGCACGGTTAGAGGCATCTGCGT: CGCACGGTTAGAGGCATCTGCGTT
CAGGATTAATCCATTGGCGAGTTG: AGGATTAATCCATTGGCGAGTTGA
CCCCATTCGCCTCTACCAAAATCC: CCCATTCGCCTCTACCAAAATCCT
AATGCAGTTCCTAATCAGACTGTT: ATGCAGTTCCTAATCAGACTGTTT
AACGGAACACTTAAACGGGCGGGT: ACGGAACACTTAAACGGGCGGGTA
CTTTATTTGCGCACGGTTAGAGGC: TTTATTTGCGCACGGTTAGAGGCA
TGGGTTAGGGAGGTGTTCTTATAG: GGGTTAGGGAGGTGTTCTTATAGT
ATCAGACTGTTTAGGGCTTCGACG: TCAGACTGTTTAGGGCTTCGACGC
CAATGCTGGAAAGTCCTTTATTTG: AATGCTGGAAAGTCCTTTATTTGC
GTGGGCGCTTCTGCTATACAGGTG: TGGGCGCTTCTGCTATACAGGTGT
GTCCACGAATCTTTCCCCTCCCTC: TCCACGAATCTTTCCCCTCCCTCA
TCACATAATGGATCCAACCAGGTG: CACATAATGGATCCAACCAGGTGA
GGAACACTTAAACGGGCGGGTATT: GAACACTTAAACGGGCGGGTATTT
CGGGTATTTCCTGTGGCCAAGTCC: GGGTATTTCCTGTGGCCAAGTCCT
TGCCGATACGTCACATACAAACAT: GCCGATACGTCACATACAAACATA
GCCAGATATTCCCGACTATTCGGT: CCAGATATTCCCGACTATTCGGTA
ATACAGTGATTTACGCTTAGGTAT: TACAGTGATTTACGCTTAGGTATT
AGGGATTCCACACTCCTACGATTA: GGGATTCCACACTCCTACGATTAT
TTGCTGGCTTGGGCAAGGCAACAT: TGCTGGCTTGGGCAAGGCAACATT
GATCCAACCAGGTGACCCACGGTG: ATCCAACCAGGTGACCCACGGTGT
TCAGGAACCCGTATTTCAGTAGAA: CAGGAACCCGTATTTCAGTAGAAA
TGCTTTATCCGGCCCGTCAGCGTT: GCTTTATCCGGCCCGTCAGCGTTC
CGAGTCCACGGTGCGCTAACGGTG: GAGTCCACGGTGCGCTAACGGTGA
GGTGCAGGACCTCAGTGTGAGGTT: GTGCAGGACCTCAGTGTGAGGTTA
CCGTCAGCGTTCAGTTAGAAGAGA: CGTCAGCGTTCAGTTAGAAGAGAC
GAGCCCCAACAGGTGGATAAACTA: AGCCCCAACAGGTGGATAAACTAA
GTTAAGCGATTTTACTTATCTGAG: TTAAGCGATTTTACTTATCTGAGC
TTAGACTCTTGAAGGGCAACGACG: TAGACTCTTGAAGGGCAACGACGC
GTGATAACCGAGCCCCAACAGGTG: TGATAACCGAGCCCCAACAGGTGG
TAACAAGTTAAGCGATTTTACTTA: AACAAGTTAAGCGATTTTACTTAT
AACTTGGCAGCATAGCAAGGACTG: ACTTGGCAGCATAGCAAGGACTGT
TGGATACGTCTCTAATACCCTCGG: GGATACGTCTCTAATACCCTCGGA
TGCACAATGATGGCGACCCGTTCC: GCACAATGATGGCGACCCGTTCCA
TCACTTGATCCACAGGTTAGTGCA: CACTTGATCCACAGGTTAGTGCAC
AGGGCGAACATGTGTTTGTGTAGC: GGGCGAACATGTGTTTGTGTAGCT
GCAGCAATGCTCACTCGGTAAGTA: CAGCAATGCTCACTCGGTAAGTAA
ACCAACAGGGCGAACATGTGTTTG: CCAACAGGGCGAACATGTGTTTGT
TATTCGGTACAGAATACCAGTACA: ATTCGGTACAGAATACCAGTACAG
GTTGGCGCCCATGAGCACCGGTCC: TTGGCGCCCATGAGCACCGGTCCC
AACAAGTTAAGCGATTTTACTTAT: ACAAGTTAAGCGATTTTACTTATC
TGTAAGCACATTGTACGATGTTGG: GTAAGCACATTGTACGATGTTGGA
CAGATACCGGCGAACATGCCGATA: AGATACCGGCGAACATGCCGATAC
TGGCGCCCATGAGCACCGGTCCCC: GGCGCCCATGAGCACCGGTCCCCG
GTGGCATGCGTGACCTTGTAAGAG: TGGCATGCGTGACCTTGTAAGAGT
GTCCTACTTCACCGGCTAGTTGCA: TCCTACTTCACCGGCTAGTTGCAC
GGTTGCGGCATAGATGGTTGGATG: GTTGCGGCATAGATGGTTGGATGC
ATGTTGCACGTTTGTCCAATTCAA: TGTTGCACGTTTGTCCAATTCAAT
GGCCGAGAGGATCGTAGTGTAAAA: GCCGAGAGGATCGTAGTGTAAAAA
TCCACGGACAACCAGTTGTCTCAG: CCACGGACAACCAGTTGTCTCAGG
GGAATCCGGATGAATCTCTGCAGA: GAATCCGGATGAATCTCTGCAGAG
CCCCCTAGGTAAGGCGGTCACTGC: CCCCTAGGTAAGGCGGTCACTGCA
AAAGATAACACGCACATGTTTACT: AAGATAACACGCACATGTTTACTA
GCGCTAACGGTGATGCATGGACAG: CGCTAACGGTGATGCATGGACAGA
TAGCACGTGGGAAAATACCGGGCA: AGCACGTGGGAAAATACCGGGCAA
ACACTACCAACAGGGCGAACATGT: CACTACCAACAGGGCGAACATGTG
CCATAACATCAGACCTGTTTCCGA: CATAACATCAGACCTGTTTCCGAT
TGGTATACTCTCCACTTATTATTG: GGTATACTCTCCACTTATTATTGC
CGGGTTGTTAACTTAACAGACGCA: GGGTTGTTAACTTAACAGACGCAG
AGCCCTCGGATCCCATAACATCAG: GCCCTCGGATCCCATAACATCAGA
AAACCGTCAGACTGGTCAGTGAAA: AACCGTCAGACTGGTCAGTGAAAC
TACAAACATACTAGTGATAACCGA: ACAAACATACTAGTGATAACCGAG
TGGATGCAGAAGGACCCCTTAGAT: GGATGCAGAAGGACCCCTTAGATC
GCGGAAGAACAGGATTAATCCATT: CGGAAGAACAGGATTAATCCATTG
CAGTGAAACGGAACACTTAAACGG: AGTGAAACGGAACACTTAAACGGG
TACGCTTAGGTATTATATGCTAAC: ACGCTTAGGTATTATATGCTAACC
ACGTCACATACAAACATACTAGTG: CGTCACATACAAACATACTAGTGA
GGCAGCATAGCAAGGACTGTAGGC: GCAGCATAGCAAGGACTGTAGGCA
TCTTGGATCGTGCGCCGACTTCAT: CTTGGATCGTGCGCCGACTTCATC
TTAACAGACGCAGATACCGGCGAA: TAACAGACGCAGATACCGGCGAAC
ACGATGTTGGACGTTTCTCGCACG: CGATGTTGGACGTTTCTCGCACGT
ACAGGTGTCCCACATACTGACTTG: CAGGTGTCCCACATACTGACTTGC
GTAAATTGAGACTATAGAGGCCCG: TAAATTGAGACTATAGAGGCCCGG
GGGCGGGTATTTCCTGTGGCCAAG: GGCGGGTATTTCCTGTGGCCAAGT
ACCTTGCCATACATGTGGATACGT: CCTTGCCATACATGTGGATACGTC
ATAACACGCACATGTTTACTATAC: TAACACGCACATGTTTACTATACT
AATAACTACAATGCTGGAAAGTCC: ATAACTACAATGCTGGAAAGTCCT
TGTGAGGTTAAGCTTTTGCTGGTG: GTGAGGTTAAGCTTTTGCTGGTGT
AGGTGTCCCACATACTGACTTGCG: GGTGTCCCACATACTGACTTGCGC
TAGCCGAATGTTTCTCACTTGATC: AGCCGAATGTTTCTCACTTGATCC
GTTCTTATAGTATTACTGGTATAC: TTCTTATAGTATTACTGGTATACT
AGAACAGGATTAATCCATTGGCGA: GAACAGGATTAATCCATTGGCGAG
CCAAAGCTCCGTACCCCATTCGCC: CAAAGCTCCGTACCCCATTCGCCT
GTAGCCTCTATACAGTGATTTACG: TAGCCTCTATACAGTGATTTACGC
AGAATCAGTTGAACGTTGATGTAA: GAATCAGTTGAACGTTGATGTAAG
CTCGGATCCCATAACATCAGACCT: TCGGATCCCATAACATCAGACCTG
TTGATCCACAGGTTAGTGCACCAT: TGATCCACAGGTTAGTGCACCATC
GTTGTCTCAGGTAAATTGAGACTA: TTGTCTCAGGTAAATTGAGACTAT
CGCTGAATCGTTTTCGTAGCATGG: GCTGAATCGTTTTCGTAGCATGGA
ATCCTTCCACGGACAACCAGTTGT: TCCTTCCACGGACAACCAGTTGTC
CAGGTTCTGCAGAAGTATAGCTGA: AGGTTCTGCAGAAGTATAGCTGAC
TCTGCAGAAGTATAGCTGACAATG: CTGCAGAAGTATAGCTGACAATGT
TCGTAGTGTAAAAACTCCACAACC: CGTAGTGTAAAAACTCCACAACCA
GACCTCAGTGTGAGGTTAAGCTTT: ACCTCAGTGTGAGGTTAAGCTTTT
CTTGGATCGTGCGCCGACTTCATC: TTGGATCGTGCGCCGACTTCATCT
TGTTTAGGGCTTCGACGCGCCTTA: GTTTAGGGCTTCGACGCGCCTTAC
CTTTATCCGGCCCGTCAGCGTTCA: TTTATCCGGCCCGTCAGCGTTCAG
AGTAAGCGTGGCACTCTCGTCCTT: GTAAGCGTGGCACTCTCGTCCTTA
GTAAAAGACCTCAATATAAACATT: TAAAAGACCTCAATATAAACATTA
CTTTTCCCATCGAGCTGTTCAACT: TTTTCCCATCGAGCTGTTCAACTT
GCCACACTACCAACAGGGCGAACA: CCACACTACCAACAGGGCGAACAT
AGAAGAGACTAACACTGTTTTTTT: GAAGAGACTAACACTGTTTTTTTG
TGGCATGCGTGACCTTGTAAGAGT: GGCATGCGTGACCTTGTAAGAGTT
TTCCCCTCCCTCAGCCAGGTTGCG: TCCCCTCCCTCAGCCAGGTTGCGG
AAGTAAGCGTGGCACTCTCGTCCT: AGTAAGCGTGGCACTCTCGTCCTT
GGCGCCCATGAGCACCGGTCCCCG: GCGCCCATGAGCACCGGTCCCCGT
CAGTTGAACGTTGATGTAAGCACA: AGTTGAACGTTGATGTAAGCACAT
CCTAACCTTTTCACAAATAATTCA: CTAACCTTTTCACAAATAATTCAT
CCAAAAGTTGTGCGTAAATGGGTT: CAAAAGTTGTGCGTAAATGGGTTA
CCCTTAGATCTAGCTGCAGTTGGC: CCTTAGATCTAGCTGCAGTTGGCG
TGCAGAGTCAGTAGCCTCTATACA: GCAGAGTCAGTAGCCTCTATACAG
GCCATACATGTGGATACGTCTCTA: CCATACATGTGGATACGTCTCTAA
ATTCCACACTCCTACGATTATGCC: TTCCACACTCCTACGATTATGCCT
TCGGATCCCATAACATCAGACCTG: CGGATCCCATAACATCAGACCTGT
CAGACTGTTTAGGGCTTCGACGCG: AGACTGTTTAGGGCTTCGACGCGC
TTATATGCTAACCTACTGCTGACA: TATATGCTAACCTACTGCTGACAT
AGAAATAGGAACACACGAGTCCAC: GAAATAGGAACACACGAGTCCACG
GGTTGGATGCAGAAGGACCCCTTA: GTTGGATGCAGAAGGACCCCTTAG
GGCAATAGTGACAAAGGGTTGGGC: GCAATAGTGACAAAGGGTTGGGCA
TCGTGTAACACGCTGAAAAAAATG: CGTGTAACACGCTGAAAAAAATGC
GTGCGGCCGTCTGCGTGTCCAAAA: TGCGGCCGTCTGCGTGTCCAAAAG
GGTTGTCCTACTTCACCGGCTAGT: GTTGTCCTACTTCACCGGCTAGTT
ACGGTGCGCTAACGGTGATGCATG: CGGTGCGCTAACGGTGATGCATGG
CCGGCGAACATGCCGATACGTCAC: CGGCGAACATGCCGATACGTCACA
TGTAAGAGTTGGGACGAATCTAGC: GTAAGAGTTGGGACGAATCTAGCA
GGGCGCTTCTGCTATACAGGTGTC: GGCGCTTCTGCTATACAGGTGTCC
GTGAAAAAAGTACGTTAACTTGGT: TGAAAAAAGTACGTTAACTTGGTA
CAATCGCTACTTTGTCCACGAATC: AATCGCTACTTTGTCCACGAATCT
GATGCATGGACAGAGTTTTAGCCG: ATGCATGGACAGAGTTTTAGCCGA
TACCAAAATCCTTCCACGGACAAC: ACCAAAATCCTTCCACGGACAACC
GTGTATGAATCGTGTAACACGCTG: TGTATGAATCGTGTAACACGCTGA
CCCAGCCGTGTGAAAAAAGTACGT: CCAGCCGTGTGAAAAAAGTACGTT
TGTTCAACTTGGCAGCATAGCAAG: GTTCAACTTGGCAGCATAGCAAGG
AAGTCATTGTTAGGGATTCCACAC: AGTCATTGTTAGGGATTCCACACT
CACACTCCTACGATTATGCCTGGC: ACACTCCTACGATTATGCCTGGCC
CAATGCGAACCTTGCCATACATGT: AATGCGAACCTTGCCATACATGTG
CCTTTTCCCATCGAGCTGTTCAAC: CTTTTCCCATCGAGCTGTTCAACT
CAATTCAATCGCTACTTTGTCCAC: AATTCAATCGCTACTTTGTCCACG
CTCAGCCAGGTTGCGGCATAGATG: TCAGCCAGGTTGCGGCATAGATGG
ATTAGCACGTGGGAAAATACCGGG: TTAGCACGTGGGAAAATACCGGGC
AGTTTGTGACGCCCGCTCAGGAAC: GTTTGTGACGCCCGCTCAGGAACC
CGCCATGGAGCACACAGACTTGCT: GCCATGGAGCACACAGACTTGCTG
GAAGTATAGCTGACAATGTCACTT: AAGTATAGCTGACAATGTCACTTC
GTCACATACAAACATACTAGTGAT: TCACATACAAACATACTAGTGATA
ATTCCGCCAGATATTCCCGACTAT: TTCCGCCAGATATTCCCGACTATT
AACATTATGGATATTCCGCCAGAT: ACATTATGGATATTCCGCCAGATA
AGGATCGTAGTGTAAAAACTCCAC: GGATCGTAGTGTAAAAACTCCACA
GTAAAAACTCCACAACCAAAGTCA: TAAAAACTCCACAACCAAAGTCAT
AGGAACACACGAGTCCACGGTGCG: GGAACACACGAGTCCACGGTGCGC
ACGGGCGGGTATTTCCTGTGGCCA: CGGGCGGGTATTTCCTGTGGCCAA
GACATTCCCCCGTGCGGCCGTCTG: ACATTCCCCCGTGCGGCCGTCTGC
GAGGTTAAGCTTTTGCTGGTGTTT: AGGTTAAGCTTTTGCTGGTGTTTC
GGGTTGTTAACTTAACAGACGCAG: GGTTGTTAACTTAACAGACGCAGA
GGGCAAGGCAACATTATACCTAAG: GGCAAGGCAACATTATACCTAAGC
CATCAAAAGATAACACGCACATGT: ATCAAAAGATAACACGCACATGTT
AATGTCACTTCGGTCCGAGGCAGC: ATGTCACTTCGGTCCGAGGCAGCA
GGTGCACCTAACCTTTTCACAAAT: GTGCACCTAACCTTTTCACAAATA
TACAATACGCAAGGACACAAGTGG: ACAATACGCAAGGACACAAGTGGG
TAACCTACTGCTGACATTCCCCCG: AACCTACTGCTGACATTCCCCCGT
ACAGACTTGCTGAGGACCCGAGGA: CAGACTTGCTGAGGACCCGAGGAA
TTCCAACCTGTCACGTAAAAGACC: TCCAACCTGTCACGTAAAAGACCT
TACTATACTAGAGGGGCAAAGCAC: ACTATACTAGAGGGGCAAAGCACA
GTGTAACACGCTGAAAAAAATGCC: TGTAACACGCTGAAAAAAATGCCA
TGCACGCCACACTACCAACAGGGC: GCACGCCACACTACCAACAGGGCG
CACAGGCCGAGAGGATCGTAGTGT: ACAGGCCGAGAGGATCGTAGTGTA
AGTTGTGCGTAAATGGGTTAGGGA: GTTGTGCGTAAATGGGTTAGGGAG
GTGATGCATGGACAGAGTTTTAGC: TGATGCATGGACAGAGTTTTAGCC
TGGATATTCCGCCAGATATTCCCG: GGATATTCCGCCAGATATTCCCGA
CGTCAGTTTGTGACGCCCGCTCAG: GTCAGTTTGTGACGCCCGCTCAGG
AGATATTCCCGACTATTCGGTACA: GATATTCCCGACTATTCGGTACAG
CCACAGGTTAGTGCACCATCAAAA: CACAGGTTAGTGCACCATCAAAAG
ATACCGGCGAACATGCCGATACGT: TACCGGCGAACATGCCGATACGTC
ACAGTGATTTACGCTTAGGTATTA: CAGTGATTTACGCTTAGGTATTAT
GCAGAAGTATAGCTGACAATGTCA: CAGAAGTATAGCTGACAATGTCAC
TTTGCGAGTATCAATGTTGACATC: TTGCGAGTATCAATGTTGACATCA
AGTTGCACGCCACACTACCAACAG: GTTGCACGCCACACTACCAACAGG
GCAGTTCCTAATCAGACTGTTTAG: CAGTTCCTAATCAGACTGTTTAGG
GTTCTGCAGAAGTATAGCTGACAA: TTCTGCAGAAGTATAGCTGACAAT
GCTGGCTTGGGCAAGGCAACATTA: CTGGCTTGGGCAAGGCAACATTAT
GTGTCGTGCGCCCCCTAGGTAAGG: TGTCGTGCGCCCCCTAGGTAAGGC
AGTATAGCTGACAATGTCACTTCG: GTATAGCTGACAATGTCACTTCGG
TATTCCCGACTATTCGGTACAGAA: ATTCCCGACTATTCGGTACAGAAT
GGCACGAGGGATATTGGTTGTCCT: GCACGAGGGATATTGGTTGTCCTA
ACAGGATTAATCCATTGGCGAGTT: CAGGATTAATCCATTGGCGAGTTG
AGCCGAATGTTTCTCACTTGATCC: GCCGAATGTTTCTCACTTGATCCA
GAGTTGGGACGAATCTAGCACCAA: AGTTGGGACGAATCTAGCACCAAA
GTGCACCATCAAAAGATAACACGC: TGCACCATCAAAAGATAACACGCA
AGCCATGACTTACAATGCGAACCT: GCCATGACTTACAATGCGAACCTT
TCCGAGGCAGCAATGCTCACTCGG: CCGAGGCAGCAATGCTCACTCGGT
TCGAGCTGTTCAACTTGGCAGCAT: CGAGCTGTTCAACTTGGCAGCATA
TAAACATTATGGATATTCCGCCAG: AAACATTATGGATATTCCGCCAGA
ACACCTTGGTGCAGGACCTCAGTG: CACCTTGGTGCAGGACCTCAGTGT
GTATTTCAGTAGAAATAGGAACAC: TATTTCAGTAGAAATAGGAACACA
CTATACAGGTGTCCCACATACTGA: TATACAGGTGTCCCACATACTGAC
ATGCCGATACGTCACATACAAACA: TGCCGATACGTCACATACAAACAT
ACTTGATCCACAGGTTAGTGCACC: CTTGATCCACAGGTTAGTGCACCA
CAAGGACTGTAGGCACGAGGGATA: AAGGACTGTAGGCACGAGGGATAT
GGATTCCACACTCCTACGATTATG: GATTCCACACTCCTACGATTATGC
CTGGTGTTTCTTGGATCGTGCGCC: TGGTGTTTCTTGGATCGTGCGCCG
ATTTCAGTAGAAATAGGAACACAC: TTTCAGTAGAAATAGGAACACACG
CACGTTTGTCCAATTCAATCGCTA: ACGTTTGTCCAATTCAATCGCTAC
CGTTCCAACCTGTCACGTAAAAGA: GTTCCAACCTGTCACGTAAAAGAC
CTACAATACGCAAGGACACAAGTG: TACAATACGCAAGGACACAAGTGG
AGTAGAAATAGGAACACACGAGTC: GTAGAAATAGGAACACACGAGTCC
CAGTTTGTGACGCCCGCTCAGGAA: AGTTTGTGACGCCCGCTCAGGAAC
TGAATCGTTTTCGTAGCATGGAAA: GAATCGTTTTCGTAGCATGGAAAG
CTTCCACTAACACACCTTGGTGCA: TTCCACTAACACACCTTGGTGCAG
GGAAAGTCCTTTATTTGCGCACGG: GAAAGTCCTTTATTTGCGCACGGT
CCCGTATTTCAGTAGAAATAGGAA: CCGTATTTCAGTAGAAATAGGAAC
CGCCTTACTGGTGTCTCTCCGGCG: GCCTTACTGGTGTCTCTCCGGCGC
ACCTAAGCTTCAGAGTCCGAGTAT: CCTAAGCTTCAGAGTCCGAGTATT
TGCGTTCCTGAATGCAGTTCCTAA: GCGTTCCTGAATGCAGTTCCTAAT
TTAGCCGAATGTTTCTCACTTGAT: TAGCCGAATGTTTCTCACTTGATC
CTCGCACGTGCTGCTTTATCCGGC: TCGCACGTGCTGCTTTATCCGGCC
GATCGTAGTGTAAAAACTCCACAA: ATCGTAGTGTAAAAACTCCACAAC
GGACCTCAGTGTGAGGTTAAGCTT: GACCTCAGTGTGAGGTTAAGCTTT
GACTGGTCAGTGAAACGGAACACT: ACTGGTCAGTGAAACGGAACACTT
GGCATCTGCGTTCCTGAATGCAGT: GCATCTGCGTTCCTGAATGCAGTT
GAGGATCGTAGTGTAAAAACTCCA: AGGATCGTAGTGTAAAAACTCCAC
TGGTGCAGGACCTCAGTGTGAGGT: GGTGCAGGACCTCAGTGTGAGGTT
GTGACCTTGTAAGAGTTGGGACGA: TGACCTTGTAAGAGTTGGGACGAA
ATACGCAAGGACACAAGTGGGCGC: TACGCAAGGACACAAGTGGGCGCT
GCGAGTTGAAACCGTCAGACTGGT: CGAGTTGAAACCGTCAGACTGGTC
CGTGTAACACGCTGAAAAAAATGC: GTGTAACACGCTGAAAAAAATGCC
TGCTCACTCGGTAAGTAAGCGTGG: GCTCACTCGGTAAGTAAGCGTGGC
ATCTGAGCCATGACTTACAATGCG: TCTGAGCCATGACTTACAATGCGA
AGTTGAACGTTGATGTAAGCACAT: GTTGAACGTTGATGTAAGCACATT
CGGCCGTCTGCGTGTCCAAAAGTT: GGCCGTCTGCGTGTCCAAAAGTTG
ACGCTTAGGTATTATATGCTAACC: CGCTTAGGTATTATATGCTAACCT
TGAACGTTGATGTAAGCACATTGT: GAACGTTGATGTAAGCACATTGTA
TGAAACGGAACACTTAAACGGGCG: GAAACGGAACACTTAAACGGGCGG
CTCTCGTCCTTAACAAGTTAAGCG: TCTCGTCCTTAACAAGTTAAGCGA
CTAATCAGACTGTTTAGGGCTTCG: TAATCAGACTGTTTAGGGCTTCGA
AGCGGTTTGCTGGCTTGGGCAAGG: GCGGTTTGCTGGCTTGGGCAAGGC
AGCACGTGGGAAAATACCGGGCAA: GCACGTGGGAAAATACCGGGCAAT
GTGTTCTTATAGTATTACTGGTAT: TGTTCTTATAGTATTACTGGTATA
GAGGCCCAGCCGTGTGAAAAAAGT: AGGCCCAGCCGTGTGAAAAAAGTA
TGAGGACCCGAGGAATCCGGATGA: GAGGACCCGAGGAATCCGGATGAA
ACAAGTTAAGCGATTTTACTTATC: CAAGTTAAGCGATTTTACTTATCT
TGAGGTTAAGCTTTTGCTGGTGTT: GAGGTTAAGCTTTTGCTGGTGTTT
TCTCTGCAGAGTCAGTAGCCTCTA: CTCTGCAGAGTCAGTAGCCTCTAT
TAATACCCTCGGAGGCCCAGCCGT: AATACCCTCGGAGGCCCAGCCGTG
TTCCCCCGTGCGGCCGTCTGCGTG: TCCCCCGTGCGGCCGTCTGCGTGT
CATGAGCACCGGTCCCCGTACTGT: ATGAGCACCGGTCCCCGTACTGTC
ACACACCTTGGTGCAGGACCTCAG: CACACCTTGGTGCAGGACCTCAGT
TACAGTGATTTACGCTTAGGTATT: ACAGTGATTTACGCTTAGGTATTA
GTTGGGACGAATCTAGCACCAAAG: TTGGGACGAATCTAGCACCAAAGC
AACGGTGATGCATGGACAGAGTTT: ACGGTGATGCATGGACAGAGTTTT
CGGTAAGTAAGCGTGGCACTCTCG: GGTAAGTAAGCGTGGCACTCTCGT
CTGCGTTCCTGAATGCAGTTCCTA: TGCGTTCCTGAATGCAGTTCCTAA
TTTATCCGGCCCGTCAGCGTTCAG: TTATCCGGCCCGTCAGCGTTCAGT
CGTGGGAAAATACCGGGCAATAGT: GTGGGAAAATACCGGGCAATAGTG
TTGAAGGGCAACGACGCGCCATGG: TGAAGGGCAACGACGCGCCATGGA
CAGGTGTCCCACATACTGACTTGC: AGGTGTCCCACATACTGACTTGCG
AATGCTCACTCGGTAAGTAAGCGT: ATGCTCACTCGGTAAGTAAGCGTG
GGCTTCGACGCGCCTTACTGGTGT: GCTTCGACGCGCCTTACTGGTGTC
ACGTTAACTTGGTAGGTGTATGAA: CGTTAACTTGGTAGGTGTATGAAT
CAAACGTTATGCGCTGAATCGTTT: AAACGTTATGCGCTGAATCGTTTT
AAACGGGCGGGTATTTCCTGTGGC: AACGGGCGGGTATTTCCTGTGGCC
CAACCAGGTGACCCACGGTGTGTA: AACCAGGTGACCCACGGTGTGTAT
TTTTTTGCGAGTATCAATGTTGAC: TTTTTGCGAGTATCAATGTTGACA
CAGAATACCAGTACAGGTTCTGCA: AGAATACCAGTACAGGTTCTGCAG
ACTGCTGACATTCCCCCGTGCGGC: CTGCTGACATTCCCCCGTGCGGCC
TTACAATGCGAACCTTGCCATACA: TACAATGCGAACCTTGCCATACAT
AGTATTACTGGTATACTCTCCACT: GTATTACTGGTATACTCTCCACTT
TTTGTCCAATTCAATCGCTACTTT: TTGTCCAATTCAATCGCTACTTTG
AAGTCCTTTATTTGCGCACGGTTA: AGTCCTTTATTTGCGCACGGTTAG
GCGCCCCCTAGGTAAGGCGGTCAC: CGCCCCCTAGGTAAGGCGGTCACT
GCGGCATAGATGGTTGGATGCAGA: CGGCATAGATGGTTGGATGCAGAA
GCGGTTTGCTGGCTTGGGCAAGGC: CGGTTTGCTGGCTTGGGCAAGGCA
CCGCCAGATATTCCCGACTATTCG: CGCCAGATATTCCCGACTATTCGG
ACCAAAGTCATTGTTAGGGATTCC: CCAAAGTCATTGTTAGGGATTCCA
TCCACAGGTTAGTGCACCATCAAA: CCACAGGTTAGTGCACCATCAAAA
AGGGAGGTGTTCTTATAGTATTAC: GGGAGGTGTTCTTATAGTATTACT
TTCCACTAACACACCTTGGTGCAG: TCCACTAACACACCTTGGTGCAGG
GGCGAGTTGAAACCGTCAGACTGG: GCGAGTTGAAACCGTCAGACTGGT
ACACAGACTTGCTGAGGACCCGAG: CACAGACTTGCTGAGGACCCGAGG
CCCATAACATCAGACCTGTTTCCG: CCATAACATCAGACCTGTTTCCGA
CCTCGGAGGCCCAGCCGTGTGAAA: CTCGGAGGCCCAGCCGTGTGAAAA
CTTTCCCCTCCCTCAGCCAGGTTG: TTTCCCCTCCCTCAGCCAGGTTGC
GATACCGGCGAACATGCCGATACG: ATACCGGCGAACATGCCGATACGT
CATAACATCAGACCTGTTTCCGAT: ATAACATCAGACCTGTTTCCGATA
CAGACGCAGATACCGGCGAACATG: AGACGCAGATACCGGCGAACATGC
ATGTTTACTATACTAGAGGGGCAA: TGTTTACTATACTAGAGGGGCAAA
ACATTATGGATATTCCGCCAGATA: CATTATGGATATTCCGCCAGATAT
GCACGTATTCCTCTCATGTTGCAC: CACGTATTCCTCTCATGTTGCACG
AGGACCCCTTAGATCTAGCTGCAG: GGACCCCTTAGATCTAGCTGCAGT
ACTACAATGCTGGAAAGTCCTTTA: CTACAATGCTGGAAAGTCCTTTAT
AGGTGGATAAACTAAGCGGCTTAG: GGTGGATAAACTAAGCGGCTTAGA
AACAGGATTAATCCATTGGCGAGT: ACAGGATTAATCCATTGGCGAGTT
AAACTCCACAACCAAAGTCATTGT: AACTCCACAACCAAAGTCATTGTT
TCACGTAAAAGACCTCAATATAAA: CACGTAAAAGACCTCAATATAAAC
TGGCACTCTCGTCCTTAACAAGTT: GGCACTCTCGTCCTTAACAAGTTA
CCAGTTGTCTCAGGTAAATTGAGA: CAGTTGTCTCAGGTAAATTGAGAC
CGATTTTACTTATCTGAGCCATGA: GATTTTACTTATCTGAGCCATGAC
CTACGATTATGCCTGGCCACTTCT: TACGATTATGCCTGGCCACTTCTG
AAAGGGTTGGGCAAATAACTACAA: AAGGGTTGGGCAAATAACTACAAT
GTGTTTGTGTAGCTCAGATATTTT: TGTTTGTGTAGCTCAGATATTTTG
TGATCCACAGGTTAGTGCACCATC: GATCCACAGGTTAGTGCACCATCA
GACCTCAATATAAACATTATGGAT: ACCTCAATATAAACATTATGGATA
TTAGAGGCATCTGCGTTCCTGAAT: TAGAGGCATCTGCGTTCCTGAATG
GGACACAAGTGGGCGCTTCTGCTA: GACACAAGTGGGCGCTTCTGCTAT
TAGAGGCCCGGCGTGAGCACGTAT: AGAGGCCCGGCGTGAGCACGTATT
CAGTTGGCGCCCATGAGCACCGGT: AGTTGGCGCCCATGAGCACCGGTC
TCAAAAGATAACACGCACATGTTT: CAAAAGATAACACGCACATGTTTA
AAAAATGCCAGGTGTAGAGAATCA: AAAATGCCAGGTGTAGAGAATCAG
GCGCCTTACTGGTGTCTCTCCGGC: CGCCTTACTGGTGTCTCTCCGGCG
GGATACGTCTCTAATACCCTCGGA: GATACGTCTCTAATACCCTCGGAG
GACTCTTGAAGGGCAACGACGCGC: ACTCTTGAAGGGCAACGACGCGCC
CGCTGAAAAAAATGCCAGGTGTAG: GCTGAAAAAAATGCCAGGTGTAGA
CACTCTCGTCCTTAACAAGTTAAG: ACTCTCGTCCTTAACAAGTTAAGC
TACGATGTTGGACGTTTCTCGCAC: ACGATGTTGGACGTTTCTCGCACG
CTCACTCGGTAAGTAAGCGTGGCA: TCACTCGGTAAGTAAGCGTGGCAC
TTGGATCGTGCGCCGACTTCATCT: TGGATCGTGCGCCGACTTCATCTA
GGACCCGAGGAATCCGGATGAATC: GACCCGAGGAATCCGGATGAATCT
GGATATTCCGCCAGATATTCCCGA: GATATTCCGCCAGATATTCCCGAC
GCCCATGAGCACCGGTCCCCGTAC: CCCATGAGCACCGGTCCCCGTACT
TGGCCTCTTCCACTAACACACCTT: GGCCTCTTCCACTAACACACCTTG
AAGCACAGGCCGAGAGGATCGTAG: AGCACAGGCCGAGAGGATCGTAGT
TCAGGTAAATTGAGACTATAGAGG: CAGGTAAATTGAGACTATAGAGGC
AGATACCGGCGAACATGCCGATAC: GATACCGGCGAACATGCCGATACG
GGATCGTGCGCCGACTTCATCTAC: GATCGTGCGCCGACTTCATCTACA
TCCAACCAGGTGACCCACGGTGTG: CCAACCAGGTGACCCACGGTGTGT
TAACACGCTGAAAAAAATGCCAGG: AACACGCTGAAAAAAATGCCAGGT
TTCATCGTGTCGTGCGCCCCCTAG: TCATCGTGTCGTGCGCCCCCTAGG
AGGATTAATCCATTGGCGAGTTGA: GGATTAATCCATTGGCGAGTTGAA
ACTTAACAGACGCAGATACCGGCG: CTTAACAGACGCAGATACCGGCGA
TGGCTTGGGCAAGGCAACATTATA: GGCTTGGGCAAGGCAACATTATAC
TGTGGATACGTCTCTAATACCCTC: GTGGATACGTCTCTAATACCCTCG
CGAGGCAGCAATGCTCACTCGGTA: GAGGCAGCAATGCTCACTCGGTAA
CTCCGTACCCCATTCGCCTCTACC: TCCGTACCCCATTCGCCTCTACCA
TGAATCGTGTAACACGCTGAAAAA: GAATCGTGTAACACGCTGAAAAAA
GATAAACTAAGCGGCTTAGACTCT: ATAAACTAAGCGGCTTAGACTCTT
TGGAGCACACAGACTTGCTGAGGA: GGAGCACACAGACTTGCTGAGGAC
TCGTCAGTTTGTGACGCCCGCTCA: CGTCAGTTTGTGACGCCCGCTCAG
TTCTTGGATCGTGCGCCGACTTCA: TCTTGGATCGTGCGCCGACTTCAT
ATTGTTAGGGATTCCACACTCCTA: TTGTTAGGGATTCCACACTCCTAC
TCAATATAAACATTATGGATATTC: CAATATAAACATTATGGATATTCC
TCTACAATACGCAAGGACACAAGT: CTACAATACGCAAGGACACAAGTG
GGTTAGTGCACCATCAAAAGATAA: GTTAGTGCACCATCAAAAGATAAC
GGCACTCTCGTCCTTAACAAGTTA: GCACTCTCGTCCTTAACAAGTTAA
ACTGTCACATAATGGATCCAACCA: CTGTCACATAATGGATCCAACCAG
CGAACATGTGTTTGTGTAGCTCAG: GAACATGTGTTTGTGTAGCTCAGA
CGCCCATGAGCACCGGTCCCCGTA: GCCCATGAGCACCGGTCCCCGTAC
TGTAGAGAATCAGTTGAACGTTGA: GTAGAGAATCAGTTGAACGTTGAT
ACACGAGTCCACGGTGCGCTAACG: CACGAGTCCACGGTGCGCTAACGG
CAGAAGGACCCCTTAGATCTAGCT: AGAAGGACCCCTTAGATCTAGCTG
ATGCTCACTCGGTAAGTAAGCGTG: TGCTCACTCGGTAAGTAAGCGTGG
GCACTCTCGTCCTTAACAAGTTAA: CACTCTCGTCCTTAACAAGTTAAG
CACGGTGTGTATGCATAAGCGGTT: ACGGTGTGTATGCATAAGCGGTTT
CCCACGGTGTGTATGCATAAGCGG: CCACGGTGTGTATGCATAAGCGGT
CGCCCGCTCAGGAACCCGTATTTC: GCCCGCTCAGGAACCCGTATTTCA
GTCAGTAGCCTCTATACAGTGATT: TCAGTAGCCTCTATACAGTGATTT
AGCACACAGACTTGCTGAGGACCC: GCACACAGACTTGCTGAGGACCCG
CACCGGTCCCCGTACTGTCACATA: ACCGGTCCCCGTACTGTCACATAA
CGGTACAGAATACCAGTACAGGTT: GGTACAGAATACCAGTACAGGTTC
GTAGTGTAAAAACTCCACAACCAA: TAGTGTAAAAACTCCACAACCAAA
GCATCTGCGTTCCTGAATGCAGTT: CATCTGCGTTCCTGAATGCAGTTC
CTTCTGCTATACAGGTGTCCCACA: TTCTGCTATACAGGTGTCCCACAT
TATGCTAACCTACTGCTGACATTC: ATGCTAACCTACTGCTGACATTCC
GGGCAACGACGCGCCATGGAGCAC: GGCAACGACGCGCCATGGAGCACA
CTGCACAATGATGGCGACCCGTTC: TGCACAATGATGGCGACCCGTTCC
TGCTGCTTTATCCGGCCCGTCAGC: GCTGCTTTATCCGGCCCGTCAGCG
GCTGGTGTTTCTTGGATCGTGCGC: CTGGTGTTTCTTGGATCGTGCGCC
GCATGGAAAGAACCTTTTCCCATC: CATGGAAAGAACCTTTTCCCATCG
GCAAGGCAACATTATACCTAAGCT: CAAGGCAACATTATACCTAAGCTT
GGTAAGTAAGCGTGGCACTCTCGT: GTAAGTAAGCGTGGCACTCTCGTC
AGGCAACATTATACCTAAGCTTCA: GGCAACATTATACCTAAGCTTCAG
CGTTGATGTAAGCACATTGTACGA: GTTGATGTAAGCACATTGTACGAT
TGACAATGTCACTTCGGTCCGAGG: GACAATGTCACTTCGGTCCGAGGC
GATGGTTGGATGCAGAAGGACCCC: ATGGTTGGATGCAGAAGGACCCCT
CGCCTCTACCAAAATCCTTCCACG: GCCTCTACCAAAATCCTTCCACGG
CGCGGAAGAACAGGATTAATCCAT: GCGGAAGAACAGGATTAATCCATT
AAAATACCGGGCAATAGTGACAAA: AAATACCGGGCAATAGTGACAAAG
GTCAGTTTGTGACGCCCGCTCAGG: TCAGTTTGTGACGCCCGCTCAGGA
TACTGTCACATAATGGATCCAACC: ACTGTCACATAATGGATCCAACCA
AGAGGCCCGGCGTGAGCACGTATT: GAGGCCCGGCGTGAGCACGTATTC
TGTGCGTAAATGGGTTAGGGAGGT: GTGCGTAAATGGGTTAGGGAGGTG
TTCAATCGCTACTTTGTCCACGAA: TCAATCGCTACTTTGTCCACGAAT
TTCAACTTGGCAGCATAGCAAGGA: TCAACTTGGCAGCATAGCAAGGAC
TTTTCACAAATAATTCATCGTGTC: TTTCACAAATAATTCATCGTGTCG
CCGGTCCCCGTACTGTCACATAAT: CGGTCCCCGTACTGTCACATAATG
GACTAACACTGTTTTTTTGCGAGT: ACTAACACTGTTTTTTTGCGAGTA
CTTATCTGAGCCATGACTTACAAT: TTATCTGAGCCATGACTTACAATG
CAACTTGGCAGCATAGCAAGGACT: AACTTGGCAGCATAGCAAGGACTG
TCTCAGGTAAATTGAGACTATAGA: CTCAGGTAAATTGAGACTATAGAG
CAAAAGTTGTGCGTAAATGGGTTA: AAAAGTTGTGCGTAAATGGGTTAG
TCTCGCACGTGCTGCTTTATCCGG: CTCGCACGTGCTGCTTTATCCGGC
TAGGGAGGTGTTCTTATAGTATTA: AGGGAGGTGTTCTTATAGTATTAC
CCTAGGTAAGGCGGTCACTGCACA: CTAGGTAAGGCGGTCACTGCACAA
CGTACCCCATTCGCCTCTACCAAA: GTACCCCATTCGCCTCTACCAAAA
GGTGATGCATGGACAGAGTTTTAG: GTGATGCATGGACAGAGTTTTAGC
TCGTAGCATGGAAAGAACCTTTTC: CGTAGCATGGAAAGAACCTTTTCC
TTACTGGTGTCTCTCCGGCGCCAC: TACTGGTGTCTCTCCGGCGCCACC
TCAGCCAGGTTGCGGCATAGATGG: CAGCCAGGTTGCGGCATAGATGGT
CCCGTCAGCGTTCAGTTAGAAGAG: CCGTCAGCGTTCAGTTAGAAGAGA
ATATTCCGCCAGATATTCCCGACT: TATTCCGCCAGATATTCCCGACTA
TCCCATAACATCAGACCTGTTTCC: CCCATAACATCAGACCTGTTTCCG
CAGGTAAATTGAGACTATAGAGGC: AGGTAAATTGAGACTATAGAGGCC
ATCCATTGGCGAGTTGAAACCGTC: TCCATTGGCGAGTTGAAACCGTCA
GCATGGACAGAGTTTTAGCCGAAT: CATGGACAGAGTTTTAGCCGAATG
ATTCGGTACAGAATACCAGTACAG: TTCGGTACAGAATACCAGTACAGG
GCGGGTTGTTAACTTAACAGACGC: CGGGTTGTTAACTTAACAGACGCA
TGTTTCTTGGATCGTGCGCCGACT: GTTTCTTGGATCGTGCGCCGACTT
GGTAAATTGAGACTATAGAGGCCC: GTAAATTGAGACTATAGAGGCCCG
TAGCATGGAAAGAACCTTTTCCCA: AGCATGGAAAGAACCTTTTCCCAT
TAACACACCTTGGTGCAGGACCTC: AACACACCTTGGTGCAGGACCTCA
CGGCGTGAGCACGTATTCCTCTCA: GGCGTGAGCACGTATTCCTCTCAT
GTGGCCAAGTCCTCTCTCGTCAGT: TGGCCAAGTCCTCTCTCGTCAGTT
TAAGCACATTGTACGATGTTGGAC: AAGCACATTGTACGATGTTGGACG
GGACAACCAGTTGTCTCAGGTAAA: GACAACCAGTTGTCTCAGGTAAAT
GCTACTTTGTCCACGAATCTTTCC: CTACTTTGTCCACGAATCTTTCCC
TCGGTCCGAGGCAGCAATGCTCAC: CGGTCCGAGGCAGCAATGCTCACT
ACACTCCTACGATTATGCCTGGCC: CACTCCTACGATTATGCCTGGCCA
TTAAGCGATTTTACTTATCTGAGC: TAAGCGATTTTACTTATCTGAGCC
TAGCTGCAGTTGGCGCCCATGAGC: AGCTGCAGTTGGCGCCCATGAGCA
AGTGAAACGGAACACTTAAACGGG: GTGAAACGGAACACTTAAACGGGC
CTGCAGTTGGCGCCCATGAGCACC: TGCAGTTGGCGCCCATGAGCACCG
ATATAAACATTATGGATATTCCGC: TATAAACATTATGGATATTCCGCC
GTAAATGGGTTAGGGAGGTGTTCT: TAAATGGGTTAGGGAGGTGTTCTT
CTTACAATGCGAACCTTGCCATAC: TTACAATGCGAACCTTGCCATACA
TTGTCCTACTTCACCGGCTAGTTG: TGTCCTACTTCACCGGCTAGTTGC
CCTCGGATCCCATAACATCAGACC: CTCGGATCCCATAACATCAGACCT
CGTGGCACTCTCGTCCTTAACAAG: GTGGCACTCTCGTCCTTAACAAGT
CGACGCGCCTTACTGGTGTCTCTC: GACGCGCCTTACTGGTGTCTCTCC
GAGCCATGACTTACAATGCGAACC: AGCCATGACTTACAATGCGAACCT
TATAAACATTATGGATATTCCGCC: ATAAACATTATGGATATTCCGCCA
