AAAACCAATTG: AAACCAATTGA
AAAACGTTACC: AAACGTTACCT
AAAAGAACAAT: AAAGAACAATA
AAAATACGGGG: AAATACGGGGG
AAAATCGCCTC: AAATCGCCTCC
AAAATTCGGAG: AAATTCGGAGT
AAACATCCCCT: AACATCCCCTT
AAACATCCGTA: AACATCCGTAT
AAACCAATTGA: AACCAATTGAT
AAACCCCCTTA: AACCCCCTTAA
AAACCCGGTTG: AACCCGGTTGC
AAACGTTACCT: AACGTTACCTC
AAACTAAGCAG: AACTAAGCAGG
AAAGAACAATA: AAGAACAATAC
AAAGACAGCCG: AAGACAGCCGC
AAAGCCTTATA: AAGCCTTATAG
AAAGCGATGGC: AAGCGATGGCA
AAAGCTGGAAC: AAGCTGGAACT
AAAGGAAAGTG: AAGGAAAGTGT
AAAGTGTAGTC: AAGTGTAGTCC
AAAGTTGTCAG: AAGTTGTCAGC
AAAGTTTAAGT: AAGTTTAAGTA
AAATAAGTGAA: AATAAGTGAAT
AAATACGCTTA: AATACGCTTAA
AAATACGGGGG: AATACGGGGGT
AAATCGCCTCC: AATCGCCTCCT
AAATCTCATTC: AATCTCATTCA
AAATTAGCGCG: AATTAGCGCGA
AAATTCGGAGT: AATTCGGAGTG
AAATTTGGGAC: AATTTGGGACT
AACAAACATCC: ACAAACATCCC
AACAAGGCCGG: ACAAGGCCGGG
AACAATACCGA: ACAATACCGAT
AACACGAGTGC: ACACGAGTGCA
AACATCCCCTT: ACATCCCCTTT
AACATCCGTAT: ACATCCGTATC
AACATTATTCA: ACATTATTCAT
AACCAATTGAT: ACCAATTGATA
AACCACAGAGA: ACCACAGAGAA
AACCAGGAAGT: ACCAGGAAGTA
AACCCCCTTAA: ACCCCCTTAAG
AACCCGGTTGC: ACCCGGTTGCT
AACCGCAGATT: ACCGCAGATTT
AACCTAATATG: ACCTAATATGG
AACCTCCGCAA: ACCTCCGCAAG
AACGATCCCTG: ACGATCCCTGC
AACGCAGTAAG: ACGCAGTAAGC
AACGTTACCTC: ACGTTACCTCT
AACTAAGCAGG: ACTAAGCAGGC
AACTAGGGAGA: ACTAGGGAGAA
AACTAGTGGCT: ACTAGTGGCTC
AACTATAATTG: ACTATAATTGC
AACTATCTCAG: ACTATCTCAGT
AACTCACTGCC: ACTCACTGCCC
AACTCCACGAG: ACTCCACGAGA
AACTCCTGTAG: ACTCCTGTAGA
AACTGACCCCC: ACTGACCCCCT
AACTGCACGGC: ACTGCACGGCG
AACTTCTAGCT: ACTTCTAGCTC
AACTTGTGGCT: ACTTGTGGCTG
AAGAACAATAC: AGAACAATACC
AAGAACTGACC: AGAACTGACCC
AAGAATGTCCA: AGAATGTCCAA
AAGACAGCCGC: AGACAGCCGCC
AAGAGCTCGCA: AGAGCTCGCAT
AAGATGGCATT: AGATGGCATTG
AAGCAAGTAAG: AGCAAGTAAGT
AAGCACGGTAG: AGCACGGTAGA
AAGCACGTTAA: AGCACGTTAAA
AAGCAGCTATT: AGCAGCTATTT
AAGCAGGCATA: AGCAGGCATAT
AAGCCGCTAGG: AGCCGCTAGGC
AAGCCTTATAG: AGCCTTATAGA
AAGCGATGGCA: AGCGATGGCAC
AAGCGGTCTCG: AGCGGTCTCGG
AAGCTGGAACT: AGCTGGAACTA
AAGCTTGGGTA: AGCTTGGGTAG
AAGCTTGTGCA: AGCTTGTGCAA
AAGGAAAGTGT: AGGAAAGTGTA
AAGGAGGAGTG: AGGAGGAGTGT
AAGGAGTGCTA: AGGAGTGCTAC
AAGGCAGTCAA: AGGCAGTCAAC
AAGGCCGGGCG: AGGCCGGGCGC
AAGTAAGTGGA: AGTAAGTGGAC
AAGTAATCATT: AGTAATCATTG
AAGTACAACTT: AGTACAACTTC
AAGTATTGGCA: AGTATTGGCAC
AAGTCCCATAA: AGTCCCATAAG
AAGTCCTTCGG: AGTCCTTCGGG
AAGTCGAATAT: AGTCGAATATA
AAGTGAATATC: AGTGAATATCC
AAGTGGACGAA: AGTGGACGAAA
AAGTGTAGTCC: AGTGTAGTCCT
AAGTTCAGTGC: AGTTCAGTGCT
AAGTTCTCTGC: AGTTCTCTGCG
AAGTTCTTATC: AGTTCTTATCG
AAGTTGCCTTA: AGTTGCCTTAT
AAGTTGTCAGC: AGTTGTCAGCT
AAGTTTAAGTA: AGTTTAAGTAA
AAGTTTCGTGA: AGTTTCGTGAA
AATAAGTGAAT: ATAAGTGAATA
AATACCGATTT: ATACCGATTTA
AATACGCTTAA: ATACGCTTAAC
AATACGGGGGT: ATACGGGGGTT
AATAGAGAAAT: ATAGAGAAATT
AATAGCACATG: ATAGCACATGT
AATAGTGACTT: ATAGTGACTTG
AATATATAGGT: ATATATAGGTT
AATATCCCCGC: ATATCCCCGCG
AATATGGAGAA: ATATGGAGAAG
AATCATTGCCC: ATCATTGCCCT
AATCCTCTCCA: ATCCTCTCCAG
AATCGAGCAGG: ATCGAGCAGGT
AATCGCCTCCT: ATCGCCTCCTC
AATCTCATTCA: ATCTCATTCAT
AATGAAATCTC: ATGAAATCTCA
AATGAAGCTTG: ATGAAGCTTGT
AATGACGCAGA: ATGACGCAGAC
AATGACGCATG: ATGACGCATGC
AATGACGTCGG: ATGACGTCGGC
AATGCAACTGC: ATGCAACTGCA
AATGCTCTAGT: ATGCTCTAGTG
AATGCTTCTAT: ATGCTTCTATG
AATGTCCAACT: ATGTCCAACTA
AATTAACAAAC: ATTAACAAACA
AATTAATGACG: ATTAATGACGT
AATTACGGGGC: ATTACGGGGCC
AATTAGCGCGA: ATTAGCGCGAT
AATTCGGAGTG: ATTCGGAGTGT
AATTGATAAAA: ATTGATAAAAT
AATTGCCACTT: ATTGCCACTTA
AATTGGCGCAG: ATTGGCGCAGA
AATTTACCGGC: ATTTACCGGCG
AATTTAGAACT: ATTTAGAACTA
AATTTAGATAA: ATTTAGATAAC
AATTTGGGACT: ATTTGGGACTT
AATTTTCCTCA: ATTTTCCTCAC
ACAAAATTCGG: CAAAATTCGGA
ACAAACATCCC: CAAACATCCCC
ACAACTTCTAG: CAACTTCTAGC
ACAACTTGTGG: CAACTTGTGGC
ACAAGAACTGA: CAAGAACTGAC
ACAAGGCCGGG: CAAGGCCGGGC
ACAATACCGAT: CAATACCGATT
ACAATTGGCGC: CAATTGGCGCA
ACACCGTGCAC: CACCGTGCACT
ACACGAGTGCA: CACGAGTGCAA
ACACGTGCATT: CACGTGCATTC
ACAGAGAATGA: CAGAGAATGAA
ACAGCCGCCAT: CAGCCGCCATA
ACAGCTATGCC: CAGCTATGCCA
ACAGGAGGCTA: CAGGAGGCTAA
ACATCCCCTTT: CATCCCCTTTG
ACATCCGTATC: CATCCGTATCA
ACATGTATGAA: CATGTATGAAG
ACATTAGAATT: CATTAGAATTA
ACATTATTCAT: CATTATTCATT
ACATTCGTCTG: CATTCGTCTGG
ACATTGATTTA: CATTGATTTAT
ACCAATTGATA: CCAATTGATAA
ACCACAGAGAA: CCACAGAGAAT
ACCAGGAAGTA: CCAGGAAGTAC
ACCCCCATAGT: CCCCCATAGTG
ACCCCCTATAA: CCCCCTATAAC
ACCCCCTTAAG: CCCCCTTAAGA
ACCCGGTTGCT: CCCGGTTGCTG
ACCGATTTAGT: CCGATTTAGTC
ACCGCAGATTT: CCGCAGATTTC
ACCGCAGCGGA: CCGCAGCGGAA
ACCGCTGTCGC: CCGCTGTCGCG
ACCGGCGAACG: CCGGCGAACGC
ACCGGGAGTCA: CCGGGAGTCAC
ACCGTGCACTA: CCGTGCACTAA
ACCTAATATGG: CCTAATATGGA
ACCTCCGCAAG: CCTCCGCAAGA
ACCTCTGTCCG: CCTCTGTCCGC
ACCTGCATCTG: CCTGCATCTGA
ACCTTATTATT: CCTTATTATTG
ACCTTGGTTTG: CCTTGGTTTGC
ACGAAACCCCC: CGAAACCCCCT
ACGAGAACTCC: CGAGAACTCCT
ACGAGACTTTC: CGAGACTTTCA
ACGAGTAGATT: CGAGTAGATTT
ACGAGTGCAAT: CGAGTGCAATT
ACGAGTGGGAG: CGAGTGGGAGT
ACGATCCCTGC: CGATCCCTGCG
ACGCAGACAGC: CGCAGACAGCT
ACGCAGTAAGC: CGCAGTAAGCA
ACGCATACGAG: CGCATACGAGA
ACGCATGCTAT: CGCATGCTATG
ACGCTCCTCGG: CGCTCCTCGGC
ACGCTTAACTC: CGCTTAACTCC
ACGGAATAGAG: CGGAATAGAGA
ACGGCGTACTC: CGGCGTACTCG
ACGGGAGGTTG: CGGGAGGTTGA
ACGGGGCCTCT: CGGGGCCTCTA
ACGGGGGTTAC: CGGGGGTTACA
ACGGTAGACCT: CGGTAGACCTT
ACGGTCCCGCG: CGGTCCCGCGG
ACGTAAGTCCC: CGTAAGTCCCA
ACGTCGGCTAC: CGTCGGCTACA
ACGTCGTAGAC: CGTCGTAGACA
ACGTGCATTCC: CGTGCATTCCC
ACGTTAAAACG: CGTTAAAACGT
ACGTTACCTCT: CGTTACCTCTG
ACTAAATAAGT: CTAAATAAGTG
ACTAAGCAGGC: CTAAGCAGGCA
ACTAATGACGC: CTAATGACGCA CTAATGACGCA
ACTACGCATAC: CTACGCATACG
ACTAGGGAGAA: CTAGGGAGAAT
ACTAGTACCTG: CTAGTACCTGC
ACTAGTGGCTC: CTAGTGGCTCT
ACTATAATTGC: CTATAATTGCC
ACTATCTCAGT: CTATCTCAGTT
ACTCACTGCCC: CTCACTGCCCC
ACTCATTCTTG: CTCATTCTTGG
ACTCCACGAGA: CTCCACGAGAA
ACTCCTGTAGA: CTCCTGTAGAA
ACTCGTAGGTG: CTCGTAGGTGT
ACTGACCCCCT: CTGACCCCCTA
ACTGCACGGCG: CTGCACGGCGT
ACTGCCCCTAC: CTGCCCCTACG
ACTGCTCTAGG: CTGCTCTAGGA
ACTGGCGCAAT: CTGGCGCAATT
ACTTAAAGCCT: CTTAAAGCCTT
ACTTAAGTTTC: CTTAAGTTTCG
ACTTCACTAAT: CTTCACTAATG
ACTTCGTATTG: CTTCGTATTGA
ACTTCTAGCTC: CTTCTAGCTCG
ACTTCTAGGGC: CTTCTAGGGCC
ACTTGCAGTGC: CTTGCAGTGCG
ACTTGTGGCTG: CTTGTGGCTGA
ACTTTAGCTTA: CTTTAGCTTAA
ACTTTCATGCT: CTTTCATGCTG
ACTTTGGATTA: CTTTGGATTAG
AGAAAATCGCC: GAAAATCGCCT
AGAAAGTTGTC: GAAAGTTGTCA
AGAAATTAGCG: GAAATTAGCGC
AGAACAATACC: GAACAATACCG
AGAACCAGGAA: GAACCAGGAAG
AGAACTAGGGA: GAACTAGGGAG
AGAACTCCTGT: GAACTCCTGTA
AGAACTGACCC: GAACTGACCCC
AGAAGCAAGTA: GAAGCAAGTAA
AGAATCCTCTC: GAATCCTCTCC
AGAATCGAGCA: GAATCGAGCAG
AGAATGAAATC: GAATGAAATCT
AGAATGAAGCT: GAATGAAGCTT
AGAATGTCCAA: GAATGTCCAAC
AGAATTAACAA: GAATTAACAAA
AGACAGCCGCC: GACAGCCGCCA
AGACAGCTATG: GACAGCTATGC
AGACAGGAGGC: GACAGGAGGCT
AGACATTCGTC: GACATTCGTCT
AGACCGCAGCG: GACCGCAGCGG
AGACCTTATTA: GACCTTATTAT
AGACTTTCATG: GACTTTCATGC
AGAGAAATTAG: GAGAAATTAGC
AGAGAATGAAG: GAGAATGAAGC
AGAGAGAGAGC: GAGAGAGAGCC
AGAGAGAGCCC: GAGAGAGCCCG
AGAGAGCCCGT: GAGAGCCCGTC
AGAGCCCGTCT: GAGCCCGTCTT
AGAGCTCGCAT: GAGCTCGCATA
AGATAACGATC: GATAACGATCC
AGATATGAAAG: GATATGAAAGC
AGATGCTTTAA: GATGCTTTAAT
AGATGGCATTG: GATGGCATTGA
AGATTTCACTA: GATTTCACTAA
AGATTTTGGTG: GATTTTGGTGG
AGCAAACATCC: GCAAACATCCG
AGCAAGTAAGT: GCAAGTAAGTG
AGCAATGCAAC: GCAATGCAACT
AGCACATGTAT: GCACATGTATG
AGCACGGTAGA: GCACGGTAGAC
AGCACGTTAAA: GCACGTTAAAA
AGCAGCTATTT: GCAGCTATTTT
AGCAGGCATAT: GCAGGCATATT
AGCAGGTGAGC: GCAGGTGAGCG
AGCCCACTACG: GCCCACTACGC
AGCCCGTCTTG: GCCCGTCTTGC
AGCCGCATTAT: GCCGCATTATC
AGCCGCCATAC: GCCGCCATACC
AGCCGCTAGGC: GCCGCTAGGCC
AGCCTTATAGA: GCCTTATAGAA
AGCGAGAGAGA: GCGAGAGAGAG
AGCGATGGCAC: GCGATGGCACT
AGCGCAAAAGA: GCGCAAAAGAA
AGCGCGATGGA: GCGCGATGGAC
AGCGGAACTAG: GCGGAACTAGT
AGCGGTCTCGG: GCGGTCTCGGG
AGCTATGCCAT: GCTATGCCATA
AGCTATTTTGG: GCTATTTTGGA
AGCTCGATCTT: GCTCGATCTTA
AGCTCGCATAT: GCTCGCATATT
AGCTGCCTCGC: GCTGCCTCGCG
AGCTGGAACTA: GCTGGAACTAT
AGCTGGTTCTT: GCTGGTTCTTG
AGCTTAAAGTT: GCTTAAAGTTT
AGCTTGGGTAG: GCTTGGGTAGT
AGCTTGTGCAA: GCTTGTGCAAT
AGGAAAGTGTA: GGAAAGTGTAG
AGGAAGTACAA: GGAAGTACAAC
AGGAATGCTTC: GGAATGCTTCT
AGGACTTTAGC: GGACTTTAGCT
AGGAGGACTTT: GGAGGACTTTA
AGGAGGAGTGT: GGAGGAGTGTT
AGGAGGCTAAG: GGAGGCTAAGC
AGGAGTGCTAC: GGAGTGCTACG
AGGAGTGTTAC: GGAGTGTTACA
AGGATATTCTG: GGATATTCTGT
AGGATTCGACG: GGATTCGACGG
AGGATTGCTGC: GGATTGCTGCG
AGGCACCTTGG: GGCACCTTGGT
AGGCAGTCAAC: GGCAGTCAACC
AGGCATATTGC: GGCATATTGCA
AGGCCAAGTTC: GGCCAAGTTCT
AGGCCCTAAGA: GGCCCTAAGAG
AGGCCGGGCGC: GGCCGGGCGCG
AGGCGTCGCTG: GGCGTCGCTGA
AGGCTAAGCGG: GGCTAAGCGGT
AGGGAGAATCC: GGGAGAATCCT
AGGGATTTTCA: GGGATTTTCAC
AGGGCCCAGAT: GGGCCCAGATG
AGGGGAGGGGA: GGGGAGGGGAG
AGGGGAGTTAA: GGGGAGTTAAG
AGGTAGTCTTG: GGTAGTCTTGT
AGGTCGCCATC: GGTCGCCATCT
AGGTCTGACTT: GGTCTGACTTC
AGGTCTTATTC: GGTCTTATTCA
AGGTGAGCGCA: GGTGAGCGCAA
AGGTGTTAGGC: GGTGTTAGGCA
AGGTTATACGC: GGTTATACGCT
AGGTTGAGGAT: GGTTGAGGATA
AGGTTTATCAT: GGTTTATCATA
AGTAAGCACGT: GTAAGCACGTT
AGTAAGTGGAC: GTAAGTGGACG
AGTAATCATTG: GTAATCATTGC
AGTACAACTTC: GTACAACTTCT
AGTACCTGCAT: GTACCTGCATC
AGTAGATTTTG: GTAGATTTTGG
AGTATTGGCAC: GTATTGGCACG
AGTCAACCACA: GTCAACCACAG
AGTCACTCATT: GTCACTCATTC
AGTCATGGGCC: GTCATGGGCCC
AGTCATTATCA: GTCATTATCAG
AGTCCCATAAG: GTCCCATAAGC
AGTCCTCCGAT: GTCCTCCGATT
AGTCCTTCGGG: GTCCTTCGGGA
AGTCGAATATA: GTCGAATATAT
AGTCTAGCAAA: GTCTAGCAAAC
AGTCTCCTCCT: GTCTCCTCCTC
AGTCTTGTTAG: GTCTTGTTAGC
AGTGAAACCCG: GTGAAACCCGG
AGTGAAAGGAA: GTGAAAGGAAA
AGTGAATATCC: GTGAATATCCC
AGTGACTTGCA: GTGACTTGCAG
AGTGCAATTAC: GTGCAATTACG
AGTGCGCTGAG: GTGCGCTGAGA
AGTGCTACGTA: GTGCTACGTAA
AGTGCTATTAT: GTGCTATTATA
AGTGCTTGATA: GTGCTTGATAA
AGTGGACGAAA: GTGGACGAAAC
AGTGGAGGCGT: GTGGAGGCGTC
AGTGGCTCTAG: GTGGCTCTAGG
AGTGGGAGTCT: GTGGGAGTCTA
AGTGGGGTAGG: GTGGGGTAGGT
AGTGTAAGCTT: GTGTAAGCTTG
AGTGTAGTCCT: GTGTAGTCCTC
AGTGTTACACC: GTGTTACACCG
AGTTAAAGACA: GTTAAAGACAG
AGTTAAATTTG: GTTAAATTTGG
AGTTAAGCACG: GTTAAGCACGG
AGTTCAGTGCT: GTTCAGTGCTA
AGTTCTCTGCG: GTTCTCTGCGT
AGTTCTTATCG: GTTCTTATCGT
AGTTGCCTTAT: GTTGCCTTATT
AGTTGTCAGCT: GTTGTCAGCTG
AGTTTAAGTAA: GTTTAAGTAAT
AGTTTCGTGAA: GTTTCGTGAAG
ATAAAATACGG: TAAAATACGGG
ATAAAGCTGGA: TAAAGCTGGAA
ATAACGATCCC: TAACGATCCCT
ATAACTCACTG: TAACTCACTGC
ATAAGCAGCTA: TAAGCAGCTAT
ATAAGGAGTGC: TAAGGAGTGCT
ATAAGGCAGTC: TAAGGCAGTCA
ATAAGTGAATA: TAAGTGAATAT
ATAATTGCCAC: TAATTGCCACT
ATACCCCCATA: TACCCCCATAG
ATACCGATTTA: TACCGATTTAG
ATACGAGACTT: TACGAGACTTT
ATACGCTCCTC: TACGCTCCTCG
ATACGCTTAAC: TACGCTTAACT
ATACGGGAGGT: TACGGGAGGTT
ATACGGGGGTT: TACGGGGGTTA
ATAGAATCGAG: TAGAATCGAGC
ATAGAGAAATT: TAGAGAAATTA
ATAGCACATGT: TAGCACATGTA
ATAGGTCTGAC: TAGGTCTGACT
ATAGGTTTATC: TAGGTTTATCA
ATAGTGAAACC: TAGTGAAACCC
ATAGTGACTTG: TAGTGACTTGC
ATATAGGTTTA: TATAGGTTTAT
ATATATAGGTT: TATATAGGTTT
ATATCCCCGCG: TATCCCCGCGG
ATATGAAAGCG: TATGAAAGCGA
ATATGCATCTG: TATGCATCTGA
ATATGGAGAAG: TATGGAGAAGC
ATATGGCGAGG: TATGGCGAGGA
ATATTCTGTGC: TATTCTGTGCG
ATATTGCAATT: TATTGCAATTT
ATATTGTACAT: TATTGTACATT
ATCAAATACGC: TCAAATACGCT
ATCACTTCACT: TCACTTCACTA
ATCAGGGGAGG: TCAGGGGAGGG
ATCATAAGGCA: TCATAAGGCAG
ATCATATGGCG: TCATATGGCGA
ATCATTGCCCT: TCATTGCCCTT
ATCCCCGCGGG: TCCCCGCGGGA
ATCCCCTTTGG: TCCCCTTTGGG
ATCCCTGCGGC: TCCCTGCGGCT
ATCCGTATCAC: TCCGTATCACT
ATCCTCTCCAG: TCCTCTCCAGC
ATCGAGCAGGT: TCGAGCAGGTG
ATCGCCTCCTC: TCGCCTCCTCT
ATCGCTACGAG: TCGCTACGAGT
ATCGTAGAATG: TCGTAGAATGA
ATCTAAGTTGC: TCTAAGTTGCC
ATCTATTTTGG: TCTATTTTGGC
ATCTCAGTTAA: TCTCAGTTAAA
ATCTCATTCAT: TCTCATTCATA
ATCTCCTAGGG: TCTCCTAGGGA
ATCTGAATAGT: TCTGAATAGTG
ATCTGATTGAT: TCTGATTGATC
ATCTTACTAGT: TCTTACTAGTA
ATGAAAGCGAT: TGAAAGCGATG
ATGAAATCTCA: TGAAATCTCAT
ATGAAGCTTGT: TGAAGCTTGTG
ATGAAGTATTG: TGAAGTATTGG
ATGACGCAGAC: TGACGCAGACA
ATGACGCATGC: TGACGCATGCT
ATGACGTCGGC: TGACGTCGGCT
ATGATCAAATA: TGATCAAATAC
ATGCAACTGCA: TGCAACTGCAC
ATGCACAAAAT: TGCACAAAATT
ATGCAGTTAAA: TGCAGTTAAAG
ATGCATCTGAT: TGCATCTGATT
ATGCCATACGG: TGCCATACGGG
ATGCTATGCAG: TGCTATGCAGT
ATGCTCTAGTG: TGCTCTAGTGG
ATGCTGAAGTT: TGCTGAAGTTC
ATGCTTCTATG: TGCTTCTATGG
ATGCTTTAATT: TGCTTTAATTT
ATGGACACGTG: TGGACACGTGC
ATGGAGAAGCA: TGGAGAAGCAA
ATGGAGTCATT: TGGAGTCATTA
ATGGCACTGCT: TGGCACTGCTC
ATGGCATTGAA: TGGCATTGAAT
ATGGCGAGGAA: TGGCGAGGAAT
ATGGCGTAAGG: TGGCGTAAGGA
ATGGGCCCGGT: TGGGCCCGGTT
ATGTATGAAGT: TGTATGAAGTA
ATGTCCAACTA: TGTCCAACTAT
ATTAACAAACA: TTAACAAACAT
ATTAAGCCGCT: TTAAGCCGCTA
ATTAATGACGT: TTAATGACGTC
ATTACGGGGCC: TTACGGGGCCT
ATTAGAAAATC: TTAGAAAATCG
ATTAGAATTAA: TTAGAATTAAC
ATTAGCGCGAT: TTAGCGCGATG
ATTATAAGGAG: TTATAAGGAGT
ATTATCAGGGG: TTATCAGGGGA
ATTATCATAAG: TTATCATAAGG
ATTATTCATTC: TTATTCATTCA
ATTATTGCTTA: TTATTGCTTAC
ATTCACAACTT: TTCACAACTTG
ATTCATATGCA: TTCATATGCAT
ATTCATCTATT: TTCATCTATTT
ATTCATTCATC: TTCATTCATCT
ATTCCCTCGAT: TTCCCTCGATG
ATTCGACGGTC: TTCGACGGTCC
ATTCGGAGTGT: TTCGGAGTGTA
ATTCGTCTAGC: TTCGTCTAGCG
ATTCGTCTGGG: TTCGTCTGGGC
ATTCTAGTGGG: TTCTAGTGGGG
ATTCTATCGCT: TTCTATCGCTA
ATTCTGTGCGA: TTCTGTGCGAG
ATTCTTGGAGA: TTCTTGGAGAA
ATTCTTGTTCA: TTCTTGTTCAG
ATTCTTTCGGT: TTCTTTCGGTA
ATTGAATAGCA: TTGAATAGCAC
ATTGACAAGAA: TTGACAAGAAC
ATTGATAAAAT: TTGATAAAATA
ATTGATCTAAG: TTGATCTAAGT
ATTGATTTATT: TTGATTTATTC
ATTGCAATTTA: TTGCAATTTAG
ATTGCCACTTA: TTGCCACTTAA
ATTGCCCTTTG: TTGCCCTTTGA
ATTGCTGCGGA: TTGCTGCGGAA
ATTGCTTACTT: TTGCTTACTTA
ATTGGCACGAG: TTGGCACGAGT
ATTGGCGCAGA: TTGGCGCAGAC
ATTGTACATTA: TTGTACATTAG
ATTTACCGGCG: TTTACCGGCGA
ATTTAGAACTA: TTTAGAACTAG
ATTTAGATAAC: TTTAGATAACG
ATTTAGTCATG: TTTAGTCATGG
ATTTATTCTTT: TTTATTCTTTC
ATTTCACTAAT: TTTCACTAATG
ATTTGGGACTT: TTTGGGACTTC
ATTTTCACCGC: TTTTCACCGCT
ATTTTCCTCAC: TTTTCCTCACG
ATTTTGGAAGT: TTTTGGAAGTC
ATTTTGGCAAT: TTTTGGCAATG
ATTTTGGTGGC: TTTTGGTGGCA
CAAAAGAACAA: AAAAGAACAAT
CAAAATTCGGA: AAAATTCGGAG
CAAACATCCCC: AAACATCCCCT
CAAACATCCGT: AAACATCCGTA
CAAACTAAGCA: AAACTAAGCAG
CAAATACGCTT: AAATACGCTTA
CAACACGAGTG: AACACGAGTGC
CAACCACAGAG: AACCACAGAGA
CAACCTAATAT: AACCTAATATG
CAACCTCCGCA: AACCTCCGCAA
CAACTATAATT: AACTATAATTG
CAACTGCACGG: AACTGCACGGC
CAACTTCTAGC: AACTTCTAGCT
CAACTTGTGGC: AACTTGTGGCT
CAAGAACTGAC: AAGAACTGACC
CAAGAATGTCC: AAGAATGTCCA
CAAGGCCGGGC: AAGGCCGGGCG
CAAGTAAGTGG: AAGTAAGTGGA
CAAGTTCTTAT: AAGTTCTTATC
CAATACCGATT: AATACCGATTT
CAATGCAACTG: AATGCAACTGC
CAATGCTCTAG: AATGCTCTAGT
CAATTAATGAC: AATTAATGACG
CAATTACGGGG: AATTACGGGGC
CAATTGATAAA: AATTGATAAAA
CAATTGGCGCA: AATTGGCGCAG
CAATTTAGAAC: AATTTAGAACT
CAATTTTCCTC: AATTTTCCTCA
CACAAAATTCG: ACAAAATTCGG
CACAACTTGTG: ACAACTTGTGG
CACAGAGAATG: ACAGAGAATGA
CACATGTATGA: ACATGTATGAA
CACCGCTGTCG: ACCGCTGTCGC
CACCGTGCACT: ACCGTGCACTA
CACCTTGGTTT: ACCTTGGTTTG
CACGAGAACTC: ACGAGAACTCC
CACGAGTAGAT: ACGAGTAGATT
CACGAGTGCAA: ACGAGTGCAAT
CACGGAATAGA: ACGGAATAGAG
CACGGCGTACT: ACGGCGTACTC
CACGGTAGACC: ACGGTAGACCT
CACGTGCATTC: ACGTGCATTCC
CACGTTAAAAC: ACGTTAAAACG
CACTAAATAAG: ACTAAATAAGT
CACTAATGACG: ACTAATGACGC ACTAATGACGC
CACTACGCATA: ACTACGCATAC
CACTCATTCTT: ACTCATTCTTG
CACTGCCCCTA: ACTGCCCCTAC
CACTGCTCTAG: ACTGCTCTAGG
CACTGGCGCAA: ACTGGCGCAAT
CACTTAAGTTT: ACTTAAGTTTC
CACTTCACTAA: ACTTCACTAAT
CAGACAGCTAT: AGACAGCTATG
CAGACCGCAGC: AGACCGCAGCG
CAGAGAATGAA: AGAGAATGAAG
CAGATGCTTTA: AGATGCTTTAA
CAGATTTCACT: AGATTTCACTA
CAGCCGCATTA: AGCCGCATTAT
CAGCCGCCATA: AGCCGCCATAC
CAGCGGAACTA: AGCGGAACTAG
CAGCTATGCCA: AGCTATGCCAT
CAGCTATTTTG: AGCTATTTTGG
CAGCTGGTTCT: AGCTGGTTCTT
CAGGAAGTACA: AGGAAGTACAA
CAGGAGGACTT: AGGAGGACTTT
CAGGAGGCTAA: AGGAGGCTAAG
CAGGATTGCTG: AGGATTGCTGC
CAGGCATATTG: AGGCATATTGC
CAGGGGAGGGG: AGGGGAGGGGA
CAGGTCTTATT: AGGTCTTATTC
CAGGTGAGCGC: AGGTGAGCGCA
CAGTAAGCACG: AGTAAGCACGT
CAGTCAACCAC: AGTCAACCACA
CAGTGAAAGGA: AGTGAAAGGAA
CAGTGCGCTGA: AGTGCGCTGAG
CAGTGCTATTA: AGTGCTATTAT
CAGTTAAAGAC: AGTTAAAGACA
CAGTTAAATTT: AGTTAAATTTG
CATAAGCAGCT: ATAAGCAGCTA
CATAAGGCAGT: ATAAGGCAGTC
CATACCCCCAT: ATACCCCCATA
CATACGAGACT: ATACGAGACTT
CATACGGGAGG: ATACGGGAGGT
CATAGTGAAAC: ATAGTGAAACC
CATATGCATCT: ATATGCATCTG
CATATGGCGAG: ATATGGCGAGG
CATATTGCAAT: ATATTGCAATT
CATATTGTACA: ATATTGTACAT
CATCCCCTTTG: ATCCCCTTTGG
CATCCGTATCA: ATCCGTATCAC
CATCTATTTTG: ATCTATTTTGG
CATCTCCTAGG: ATCTCCTAGGG
CATCTGAATAG: ATCTGAATAGT
CATCTGATTGA: ATCTGATTGAT
CATGCTATGCA: ATGCTATGCAG
CATGCTGAAGT: ATGCTGAAGTT
CATGGGCCCGG: ATGGGCCCGGT
CATGTATGAAG: ATGTATGAAGT
CATTAGAATTA: ATTAGAATTAA
CATTATCAGGG: ATTATCAGGGG
CATTATCATAA: ATTATCATAAG
CATTATTCATT: ATTATTCATTC
CATTCATATGC: ATTCATATGCA
CATTCATCTAT: ATTCATCTATT
CATTCCCTCGA: ATTCCCTCGAT
CATTCGTCTGG: ATTCGTCTGGG
CATTCTTGGAG: ATTCTTGGAGA
CATTGAATAGC: ATTGAATAGCA
CATTGATTTAT: ATTGATTTATT
CATTGCCCTTT: ATTGCCCTTTG
CCAAACTAAGC: CAAACTAAGCA
CCAACTATAAT: CAACTATAATT
CCAAGTTCTTA: CAAGTTCTTAT
CCAATTGATAA: CAATTGATAAA
CCACAGAGAAT: CACAGAGAATG
CCACGAGAACT: CACGAGAACTC
CCACTACGCAT: CACTACGCATA
CCACTGGCGCA: CACTGGCGCAA
CCACTTAAGTT: CACTTAAGTTT
CCAGATGCTTT: CAGATGCTTTA
CCAGCCGCATT: CAGCCGCATTA
CCAGGAAGTAC: CAGGAAGTACA
CCAGGAGGACT: CAGGAGGACTT
CCATAAGCAGC: CATAAGCAGCT
CCATACCCCCA: CATACCCCCAT
CCATACGGGAG: CATACGGGAGG
CCATAGTGAAA: CATAGTGAAAC
CCATCTCCTAG: CATCTCCTAGG
CCCACTACGCA: CCACTACGCAT
CCCACTGGCGC: CCACTGGCGCA
CCCAGATGCTT: CCAGATGCTTT
CCCATAAGCAG: CCATAAGCAGC
CCCATAGTGAA: CCATAGTGAAA
CCCCATAGTGA: CCCATAGTGAA
CCCCCATAGTG: CCCCATAGTGA
CCCCCTATAAC: CCCCTATAACT
CCCCCTTAAGA: CCCCTTAAGAT
CCCCGCGGGAA: CCCGCGGGAAC
CCCCTACGTCG: CCCTACGTCGT
CCCCTATAACT: CCCTATAACTC
CCCCTTAAGAT: CCCTTAAGATG
CCCCTTTGGGA: CCCTTTGGGAT
CCCGACTTTGG: CCGACTTTGGA
CCCGCGGGAAC: CCGCGGGAACA
CCCGCGGGCGC: CCGCGGGCGCG
CCCGGTTGCTG: CCGGTTGCTGC
CCCGGTTTTAA: CCGGTTTTAAT
CCCGTCTTGCC: CCGTCTTGCCA
CCCTAAGAGCT: CCTAAGAGCTC
CCCTACGTCGT: CCTACGTCGTA
CCCTATAACTC: CCTATAACTCA
CCCTCGATGAT: CCTCGATGATC
CCCTGCGGCTG: CCTGCGGCTGG
CCCTTAAGATG: CCTTAAGATGG
CCCTTTGACCG: CCTTTGACCGG
CCCTTTGGGAT: CCTTTGGGATT
CCGACTTTGGA: CGACTTTGGAT
CCGATTAAGCC: CGATTAAGCCG
CCGATTTAGTC: CGATTTAGTCA
CCGCAAGAATG: CGCAAGAATGT
CCGCAGATTTC: CGCAGATTTCA
CCGCAGCGGAA: CGCAGCGGAAC
CCGCATTATCA: CGCATTATCAT
CCGCCATACCC: CGCCATACCCC
CCGCGCTCCGG: CGCGCTCCGGT
CCGCGGGAACA: CGCGGGAACAT
CCGCGGGCGCG: CGCGGGCGCGA
CCGCTAGGCCA: CGCTAGGCCAA
CCGCTGTCGCG: CGCTGTCGCGA
CCGGCGAACGC: CGGCGAACGCA
CCGGGAGTCAC: CGGGAGTCACT
CCGGGCGCGTT: CGGGCGCGTTG
CCGGTTGCTGC: CGGTTGCTGCC
CCGGTTGGTGA: CGGTTGGTGAT
CCGGTTTTAAT: CGGTTTTAATT
CCGTATCACTT: CGTATCACTTC
CCGTATTCTTG: CGTATTCTTGT
CCGTCTTGCCA: CGTCTTGCCAG
CCGTGCACTAA: CGTGCACTAAA
CCTAAGAGCTC: CTAAGAGCTCG
CCTAATATGGA: CTAATATGGAG
CCTACGTCGTA: CTACGTCGTAG
CCTAGGGATTT: CTAGGGATTTT
CCTATAACTCA: CTATAACTCAC
CCTCAACACGA: CTCAACACGAG
CCTCACGGAAT: CTCACGGAATA
CCTCCGATTAA: CTCCGATTAAG
CCTCCGCAAGA: CTCCGCAAGAA
CCTCCTCAACA: CTCCTCAACAC
CCTCCTCTTTG: CTCCTCTTTGG
CCTCGATGATC: CTCGATGATCA
CCTCGCGTTAG: CTCGCGTTAGT
CCTCGGCGGCC: CTCGGCGGCCA
CCTCTAACAAG: CTCTAACAAGG
CCTCTCCAGCC: CTCTCCAGCCG
CCTCTGTCCGC: CTCTGTCCGCG
CCTCTTTGGCC: CTCTTTGGCCA
CCTGCATCTGA: CTGCATCTGAA
CCTGCGGCTGG: CTGCGGCTGGG
CCTGTAGAACC: CTGTAGAACCA
CCTTAAGATGG: CTTAAGATGGC
CCTTATAGAAT: CTTATAGAATC
CCTTATTATTG: CTTATTATTGC
CCTTATTCTAG: CTTATTCTAGT
CCTTCGGGAAA: CTTCGGGAAAA
CCTTGGTTTGC: CTTGGTTTGCA
CCTTTGACCGG: CTTTGACCGGG
CCTTTGGGATT: CTTTGGGATTC
CGAAACCCCCT: GAAACCCCCTT
CGAACGCAGTA: GAACGCAGTAA
CGAATATATAG: GAATATATAGG
CGACGGTCCCG: GACGGTCCCGC
CGACTTTGGAT: GACTTTGGATT
CGAGAACTCCT: GAGAACTCCTG
CGAGACTTTCA: GAGACTTTCAT
CGAGAGAGAGA: GAGAGAGAGAG
CGAGCAGGTGA: GAGCAGGTGAG
CGAGGAATGCT: GAGGAATGCTT
CGAGGTTATAC: GAGGTTATACG
CGAGTAGATTT: GAGTAGATTTT
CGAGTGCAATT: GAGTGCAATTA
CGAGTGGGAGT: GAGTGGGAGTC
CGATAGGTCTG: GATAGGTCTGA
CGATCCCTGCG: GATCCCTGCGG
CGATCTTACTA: GATCTTACTAG
CGATGATCAAA: GATGATCAAAT
CGATGGACACG: GATGGACACGT
CGATGGCACTG: GATGGCACTGC
CGATTAAGCCG: GATTAAGCCGC
CGATTCTATCG: GATTCTATCGC
CGATTTAGTCA: GATTTAGTCAT
CGCAAAAGAAC: GCAAAAGAACA
CGCAAGAATGT: GCAAGAATGTC
CGCAATTAATG: GCAATTAATGA
CGCAGACAGCT: GCAGACAGCTA
CGCAGACCGCA: GCAGACCGCAG
CGCAGATTTCA: GCAGATTTCAC
CGCAGCGGAAC: GCAGCGGAACT
CGCAGTAAGCA: GCAGTAAGCAC
CGCATACGAGA: GCATACGAGAC
CGCATATTGTA: GCATATTGTAC
CGCATGCTATG: GCATGCTATGC
CGCATTATCAT: GCATTATCATA
CGCCATACCCC: GCCATACCCCC
CGCCATCTCCT: GCCATCTCCTA
CGCCTCCTCTT: GCCTCCTCTTT
CGCGATAGGTC: GCGATAGGTCT
CGCGATGGACA: GCGATGGACAC
CGCGATTCTAT: GCGATTCTATC
CGCGCTCCGGT: GCGCTCCGGTT
CGCGGGAACAT: GCGGGAACATT
CGCGGGCGCGA: GCGGGCGCGAT
CGCGTTAGTCT: GCGTTAGTCTC
CGCGTTGGGAG: GCGTTGGGAGA
CGCTACGAGTG: GCTACGAGTGG
CGCTAGGCCAA: GCTAGGCCAAG
CGCTCCGGTTG: GCTCCGGTTGG
CGCTCCTCGGC: GCTCCTCGGCG
CGCTGAACCGC: GCTGAACCGCA
CGCTGAGACAT: GCTGAGACATT
CGCTGTCGCGA: GCTGTCGCGAT
CGCTTAACTCC: GCTTAACTCCA
CGGAACTAGTG: GGAACTAGTGG
CGGAAGTTCTC: GGAAGTTCTCT
CGGAATAGAGA: GGAATAGAGAA
CGGAGTGTAAG: GGAGTGTAAGC
CGGCCATCAGG: GGCCATCAGGG
CGGCGAACGCA: GGCGAACGCAG
CGGCGGCCATC: GGCGGCCATCA
CGGCGTACTCG: GGCGTACTCGT
CGGCTACATTG: GGCTACATTGA
CGGCTGGGTTC: GGCTGGGTTCC
CGGGAAAACCA: GGGAAAACCAA
CGGGAACATTA: GGGAACATTAT
CGGGAGGTTGA: GGGAGGTTGAG
CGGGAGTCACT: GGGAGTCACTC
CGGGCGCGATT: GGGCGCGATTC
CGGGCGCGTTG: GGGCGCGTTGG
CGGGGCCTCTA: GGGGCCTCTAA
CGGGGGTTACA: GGGGGTTACAA
CGGGTTGTATG: GGGTTGTATGG
CGGTAGACCTT: GGTAGACCTTA
CGGTAGCAATG: GGTAGCAATGC
CGGTCCCGCGG: GGTCCCGCGGG
CGGTCTCGGGT: GGTCTCGGGTT
CGGTTGAGGCC: GGTTGAGGCCC
CGGTTGCTGCC: GGTTGCTGCCC
CGGTTGGTGAT: GGTTGGTGATG
CGGTTTTAATT: GGTTTTAATTT
CGTAAGGAGGA: GTAAGGAGGAG
CGTAAGTCCCA: GTAAGTCCCAT
CGTACTCGTAG: GTACTCGTAGG
CGTAGAATGAA: GTAGAATGAAA
CGTAGACAGGA: GTAGACAGGAG
CGTAGGTGTTA: GTAGGTGTTAG
CGTATCACTTC: GTATCACTTCA
CGTATTCTTGT: GTATTCTTGTT
CGTATTGACAA: GTATTGACAAG
CGTCGCTGAAC: GTCGCTGAACC
CGTCGGCTACA: GTCGGCTACAT
CGTCGTAGACA: GTCGTAGACAG
CGTCTAGCGAG: GTCTAGCGAGA
CGTCTGGGCAG: GTCTGGGCAGG
CGTCTTGCCAG: GTCTTGCCAGG
CGTGAAGTCGA: GTGAAGTCGAA
CGTGCACTAAA: GTGCACTAAAT
CGTGCATTCCC: GTGCATTCCCT
CGTGTCGGTTG: GTGTCGGTTGA
CGTTAAAACGT: GTTAAAACGTT
CGTTACCTCTG: GTTACCTCTGT
CGTTAGTCTCC: GTTAGTCTCCT
CGTTGGGAGAT: GTTGGGAGATA
CTAAATAAGTG: TAAATAAGTGA
CTAACAAGGCC: TAACAAGGCCG
CTAAGAGCTCG: TAAGAGCTCGC
CTAAGCAGGCA: TAAGCAGGCAT
CTAAGCGGTCT: TAAGCGGTCTC
CTAAGTTGCCT: TAAGTTGCCTT
CTAATATGGAG: TAATATGGAGA
CTAATGACGCA: TAATGACGCAT TAATGACGCAG
CTACATTGATT: TACATTGATTT
CTACGAGTGGG: TACGAGTGGGA
CTACGCATACG: TACGCATACGA
CTACGTAAGTC: TACGTAAGTCC
CTACGTCGTAG: TACGTCGTAGA
CTAGCAAACAT: TAGCAAACATC
CTAGCGAGAGA: TAGCGAGAGAG
CTAGCTCGATC: TAGCTCGATCT
CTAGGATTCGA: TAGGATTCGAC
CTAGGCCAAGT: TAGGCCAAGTT
CTAGGGAGAAT: TAGGGAGAATC
CTAGGGATTTT: TAGGGATTTTC
CTAGGGCCCAG: TAGGGCCCAGA
CTAGGTCGCCA: TAGGTCGCCAT
CTAGTACCTGC: TAGTACCTGCA
CTAGTGGAGGC: TAGTGGAGGCG
CTAGTGGCTCT: TAGTGGCTCTA
CTAGTGGGGTA: TAGTGGGGTAG
CTATAACTCAC: TATAACTCACT
CTATAATTGCC: TATAATTGCCA
CTATCGCTACG: TATCGCTACGA
CTATCTCAGTT: TATCTCAGTTA
CTATGCAGTTA: TATGCAGTTAA
CTATGCCATAC: TATGCCATACG
CTATGGAGTCA: TATGGAGTCAT
CTATTATAAGG: TATTATAAGGA
CTATTTTGGAA: TATTTTGGAAG
CTATTTTGGCA: TATTTTGGCAA
CTCAACACGAG: TCAACACGAGT
CTCACGGAATA: TCACGGAATAG
CTCACTGCCCC: TCACTGCCCCT
CTCAGTTAAAT: TCAGTTAAATT
CTCATTCATAT: TCATTCATATG
CTCATTCTTGG: TCATTCTTGGA
CTCCACGAGAA: TCCACGAGAAC
CTCCAGCCGCA: TCCAGCCGCAT
CTCCGATTAAG: TCCGATTAAGC
CTCCGCAAGAA: TCCGCAAGAAT
CTCCGGTTGGT: TCCGGTTGGTG
CTCCTAGGGAT: TCCTAGGGATT
CTCCTCAACAC: TCCTCAACACG
CTCCTCCTCAA: TCCTCCTCAAC
CTCCTCGGCGG: TCCTCGGCGGC
CTCCTCTTTGG: TCCTCTTTGGC
CTCCTGTAGAA: TCCTGTAGAAC
CTCGATCTTAC: TCGATCTTACT
CTCGATGATCA: TCGATGATCAA
CTCGCATATTG: TCGCATATTGT
CTCGCGTTAGT: TCGCGTTAGTC
CTCGGCGGCCA: TCGGCGGCCAT
CTCGGGTTGTA: TCGGGTTGTAT
CTCGTAGGTGT: TCGTAGGTGTT
CTCTAACAAGG: TCTAACAAGGC
CTCTAGGATTC: TCTAGGATTCG
CTCTAGGTCGC: TCTAGGTCGCC
CTCTAGTGGAG: TCTAGTGGAGG
CTCTCCAGCCG: TCTCCAGCCGC
CTCTGCGTGTC: TCTGCGTGTCG
CTCTGTCCGCG: TCTGTCCGCGC
CTCTTTGGCCA: TCTTTGGCCAA
CTGAACCGCAG: TGAACCGCAGA
CTGAAGTTCAG: TGAAGTTCAGT
CTGAATAGTGA: TGAATAGTGAC
CTGACCCCCTA: TGACCCCCTAT
CTGACTTCTAG: TGACTTCTAGG
CTGAGACATTC: TGAGACATTCG
CTGAGCCCACT: TGAGCCCACTA
CTGATTGATCT: TGATTGATCTA
CTGCACGGCGT: TGCACGGCGTA
CTGCATCTGAA: TGCATCTGAAT
CTGCCCCTACG: TGCCCCTACGT
CTGCCCGACTT: TGCCCGACTTT
CTGCCTCGCGT: TGCCTCGCGTT
CTGCGGAAGTT: TGCGGAAGTTC
CTGCGGCTGGG: TGCGGCTGGGT
CTGCGTGTCGG: TGCGTGTCGGT
CTGCTCTAGGA: TGCTCTAGGAT
CTGGAACTATC: TGGAACTATCT
CTGGCGCAATT: TGGCGCAATTA
CTGGGCAGGAT: TGGGCAGGATT
CTGGGTTCCGT: TGGGTTCCGTA
CTGGTTCTTGG: TGGTTCTTGGC
CTGTAGAACCA: TGTAGAACCAG
CTGTCCGCGCT: TGTCCGCGCTC
CTGTCGCGATA: TGTCGCGATAG
CTGTGCGAGGT: TGTGCGAGGTT
CTTAAAGCCTT: TTAAAGCCTTA
CTTAAAGTTTA: TTAAAGTTTAA
CTTAACTCCAC: TTAACTCCACG
CTTAAGATGGC: TTAAGATGGCA
CTTAAGTTTCG: TTAAGTTTCGT
CTTACTAGTAC: TTACTAGTACC
CTTACTTAAAG: TTACTTAAAGC
CTTATAGAATC: TTATAGAATCG
CTTATCGTAGA: TTATCGTAGAA
CTTATTATTGC: TTATTATTGCT
CTTATTCACAA: TTATTCACAAC
CTTATTCTAGT: TTATTCTAGTG
CTTCACTAATG: TTCACTAATGA
CTTCGGGAAAA: TTCGGGAAAAC
CTTCGTATTGA: TTCGTATTGAC
CTTCTAGCTCG: TTCTAGCTCGA
CTTCTAGGGCC: TTCTAGGGCCC
CTTCTATGGAG: TTCTATGGAGT
CTTGATAAAGC: TTGATAAAGCT
CTTGCAGTGCG: TTGCAGTGCGC
CTTGCCAGGAG: TTGCCAGGAGG
CTTGGAGAAAG: TTGGAGAAAGT
CTTGGCAACCT: TTGGCAACCTC
CTTGGGTAGTG: TTGGGTAGTGC
CTTGGTTTGCA: TTGGTTTGCAA
CTTGTGCAATT: TTGTGCAATTT
CTTGTGGCTGA: TTGTGGCTGAG
CTTGTTAGCTG: TTGTTAGCTGC
CTTGTTCAGGT: TTGTTCAGGTC
CTTTAATTTAC: TTTAATTTACC
CTTTAGCTTAA: TTTAGCTTAAA
CTTTCATGCTG: TTTCATGCTGA
CTTTCGGTAGC: TTTCGGTAGCA
CTTTGACCGGG: TTTGACCGGGA
CTTTGGATTAG: TTTGGATTAGA
CTTTGGCCAAA: TTTGGCCAAAC
CTTTGGGATTC: TTTGGGATTCG
GAAAACCAATT: AAAACCAATTG
GAAAATCGCCT: AAAATCGCCTC
GAAACCCCCTT: AAACCCCCTTA
GAAACCCGGTT: AAACCCGGTTG
GAAAGCGATGG: AAAGCGATGGC
GAAAGGAAAGT: AAAGGAAAGTG
GAAAGTGTAGT: AAAGTGTAGTC
GAAAGTTGTCA: AAAGTTGTCAG
GAAATCTCATT: AAATCTCATTC
GAAATTAGCGC: AAATTAGCGCG
GAACAATACCG: AACAATACCGA
GAACATTATTC: AACATTATTCA
GAACCAGGAAG: AACCAGGAAGT
GAACCGCAGAT: AACCGCAGATT
GAACGCAGTAA: AACGCAGTAAG
GAACTAGGGAG: AACTAGGGAGA
GAACTAGTGGC: AACTAGTGGCT
GAACTATCTCA: AACTATCTCAG
GAACTCCTGTA: AACTCCTGTAG
GAACTGACCCC: AACTGACCCCC
GAAGCAAGTAA: AAGCAAGTAAG
GAAGCTTGTGC: AAGCTTGTGCA
GAAGTACAACT: AAGTACAACTT
GAAGTATTGGC: AAGTATTGGCA
GAAGTCCTTCG: AAGTCCTTCGG
GAAGTCGAATA: AAGTCGAATAT
GAAGTTCAGTG: AAGTTCAGTGC
GAAGTTCTCTG: AAGTTCTCTGC
GAATAGAGAAA: AATAGAGAAAT
GAATAGCACAT: AATAGCACATG
GAATAGTGACT: AATAGTGACTT
GAATATATAGG: AATATATAGGT
GAATATCCCCG: AATATCCCCGC
GAATCCTCTCC: AATCCTCTCCA
GAATCGAGCAG: AATCGAGCAGG
GAATGAAATCT: AATGAAATCTC
GAATGAAGCTT: AATGAAGCTTG
GAATGCTTCTA: AATGCTTCTAT
GAATGTCCAAC: AATGTCCAACT
GAATTAACAAA: AATTAACAAAC
GACAAGAACTG: ACAAGAACTGA
GACACGTGCAT: ACACGTGCATT
GACAGCCGCCA: ACAGCCGCCAT
GACAGCTATGC: ACAGCTATGCC
GACAGGAGGCT: ACAGGAGGCTA
GACATTCGTCT: ACATTCGTCTG
GACCCCCTATA: ACCCCCTATAA
GACCGCAGCGG: ACCGCAGCGGA
GACCGGGAGTC: ACCGGGAGTCA
GACCTTATTAT: ACCTTATTATT
GACGAAACCCC: ACGAAACCCCC
GACGCAGACAG: ACGCAGACAGC
GACGCATGCTA: ACGCATGCTAT
GACGGTCCCGC: ACGGTCCCGCG
GACGTCGGCTA: ACGTCGGCTAC
GACTTCGTATT: ACTTCGTATTG
GACTTCTAGGG: ACTTCTAGGGC
GACTTGCAGTG: ACTTGCAGTGC
GACTTTAGCTT: ACTTTAGCTTA
GACTTTCATGC: ACTTTCATGCT
GACTTTGGATT: ACTTTGGATTA
GAGAAAGTTGT: AGAAAGTTGTC
GAGAAATTAGC: AGAAATTAGCG
GAGAACTCCTG: AGAACTCCTGT
GAGAAGCAAGT: AGAAGCAAGTA
GAGAATCCTCT: AGAATCCTCTC
GAGAATGAAGC: AGAATGAAGCT
GAGACATTCGT: AGACATTCGTC
GAGACTTTCAT: AGACTTTCATG
GAGAGAGAGAG: AGAGAGAGAGC
GAGAGAGAGCC: AGAGAGAGCCC
GAGAGAGCCCG: AGAGAGCCCGT
GAGAGCCCGTC: AGAGCCCGTCT
GAGATATGAAA: AGATATGAAAG
GAGCAGGTGAG: AGCAGGTGAGC
GAGCCCACTAC: AGCCCACTACG
GAGCCCGTCTT: AGCCCGTCTTG
GAGCGCAAAAG: AGCGCAAAAGA
GAGCTCGCATA: AGCTCGCATAT
GAGGAATGCTT: AGGAATGCTTC
GAGGACTTTAG: AGGACTTTAGC
GAGGAGTGTTA: AGGAGTGTTAC
GAGGATATTCT: AGGATATTCTG
GAGGCCCTAAG: AGGCCCTAAGA
GAGGCGTCGCT: AGGCGTCGCTG
GAGGCTAAGCG: AGGCTAAGCGG
GAGGGGAGTTA: AGGGGAGTTAA
GAGGTTATACG: AGGTTATACGC
GAGGTTGAGGA: AGGTTGAGGAT
GAGTAGATTTT: AGTAGATTTTG
GAGTCACTCAT: AGTCACTCATT
GAGTCATTATC: AGTCATTATCA
GAGTCTAGCAA: AGTCTAGCAAA
GAGTGCAATTA: AGTGCAATTAC
GAGTGCTACGT: AGTGCTACGTA
GAGTGGGAGTC: AGTGGGAGTCT
GAGTGTAAGCT: AGTGTAAGCTT
GAGTGTTACAC: AGTGTTACACC
GAGTTAAGCAC: AGTTAAGCACG
GATAAAATACG: ATAAAATACGG
GATAAAGCTGG: ATAAAGCTGGA
GATAACGATCC: ATAACGATCCC
GATAGGTCTGA: ATAGGTCTGAC
GATATGAAAGC: ATATGAAAGCG
GATATTCTGTG: ATATTCTGTGC
GATCAAATACG: ATCAAATACGC
GATCCCTGCGG: ATCCCTGCGGC
GATCTAAGTTG: ATCTAAGTTGC
GATCTTACTAG: ATCTTACTAGT
GATGATCAAAT: ATGATCAAATA
GATGCACAAAA: ATGCACAAAAT
GATGCTTTAAT: ATGCTTTAATT
GATGGACACGT: ATGGACACGTG
GATGGCACTGC: ATGGCACTGCT
GATGGCATTGA: ATGGCATTGAA
GATTAAGCCGC: ATTAAGCCGCT
GATTAGAAAAT: ATTAGAAAATC
GATTCGACGGT: ATTCGACGGTC
GATTCGTCTAG: ATTCGTCTAGC
GATTCTATCGC: ATTCTATCGCT
GATTGATCTAA: ATTGATCTAAG
GATTGCTGCGG: ATTGCTGCGGA
GATTTAGTCAT: ATTTAGTCATG
GATTTATTCTT: ATTTATTCTTT
GATTTCACTAA: ATTTCACTAAT
GATTTTCACCG: ATTTTCACCGC
GATTTTGGTGG: ATTTTGGTGGC
GCAAAAGAACA: CAAAAGAACAA
GCAAACATCCG: CAAACATCCGT
GCAACCTAATA: CAACCTAATAT
GCAACCTCCGC: CAACCTCCGCA
GCAACTGCACG: CAACTGCACGG
GCAAGAATGTC: CAAGAATGTCC
GCAAGTAAGTG: CAAGTAAGTGG
GCAATGCAACT: CAATGCAACTG
GCAATGCTCTA: CAATGCTCTAG
GCAATTAATGA: CAATTAATGAC
GCAATTACGGG: CAATTACGGGG
GCAATTTAGAA: CAATTTAGAAC
GCAATTTTCCT: CAATTTTCCTC
GCACAAAATTC: CACAAAATTCG
GCACATGTATG: CACATGTATGA
GCACCTTGGTT: CACCTTGGTTT
GCACGAGTAGA: CACGAGTAGAT
GCACGGCGTAC: CACGGCGTACT
GCACGGTAGAC: CACGGTAGACC
GCACGTTAAAA: CACGTTAAAAC
GCACTAAATAA: CACTAAATAAG
GCACTGCTCTA: CACTGCTCTAG
GCAGACAGCTA: CAGACAGCTAT
GCAGACCGCAG: CAGACCGCAGC
GCAGATTTCAC: CAGATTTCACT
GCAGCGGAACT: CAGCGGAACTA
GCAGCTATTTT: CAGCTATTTTG
GCAGGATTGCT: CAGGATTGCTG
GCAGGCATATT: CAGGCATATTG
GCAGGTGAGCG: CAGGTGAGCGC
GCAGTAAGCAC: CAGTAAGCACG
GCAGTCAACCA: CAGTCAACCAC
GCAGTGAAAGG: CAGTGAAAGGA
GCAGTGCGCTG: CAGTGCGCTGA
GCAGTTAAAGA: CAGTTAAAGAC
GCATACGAGAC: CATACGAGACT
GCATATTGCAA: CATATTGCAAT
GCATATTGTAC: CATATTGTACA
GCATCTGAATA: CATCTGAATAG
GCATCTGATTG: CATCTGATTGA
GCATGCTATGC: CATGCTATGCA
GCATTATCATA: CATTATCATAA
GCATTCCCTCG: CATTCCCTCGA
GCATTGAATAG: CATTGAATAGC
GCCAAACTAAG: CCAAACTAAGC
GCCAAGTTCTT: CCAAGTTCTTA
GCCACTTAAGT: CCACTTAAGTT
GCCAGGAGGAC: CCAGGAGGACT
GCCATACCCCC: CCATACCCCCA
GCCATACGGGA: CCATACGGGAG
GCCATCTCCTA: CCATCTCCTAG
GCCCACTACGC: CCCACTACGCA
GCCCACTGGCG: CCCACTGGCGC
GCCCAGATGCT: CCCAGATGCTT
GCCCCTACGTC: CCCCTACGTCG
GCCCGACTTTG: CCCGACTTTGG
GCCCGGTTTTA: CCCGGTTTTAA
GCCCGTCTTGC: CCCGTCTTGCC
GCCCTAAGAGC: CCCTAAGAGCT
GCCCTTTGACC: CCCTTTGACCG
GCCGCATTATC: CCGCATTATCA
GCCGCCATACC: CCGCCATACCC
GCCGCTAGGCC: CCGCTAGGCCA
GCCGGGCGCGT: CCGGGCGCGTT
GCCTCCTCTTT: CCTCCTCTTTG
GCCTCGCGTTA: CCTCGCGTTAG
GCCTCTAACAA: CCTCTAACAAG
GCCTTATAGAA: CCTTATAGAAT
GCCTTATTCTA: CCTTATTCTAG
GCGAACGCAGT: CGAACGCAGTA
GCGAGAGAGAG: CGAGAGAGAGA
GCGAGGAATGC: CGAGGAATGCT
GCGAGGTTATA: CGAGGTTATAC
GCGATAGGTCT: CGATAGGTCTG
GCGATGGACAC: CGATGGACACG
GCGATGGCACT: CGATGGCACTG
GCGATTCTATC: CGATTCTATCG
GCGCAAAAGAA: CGCAAAAGAAC
GCGCAATTAAT: CGCAATTAATG
GCGCAGACCGC: CGCAGACCGCA
GCGCGATGGAC: CGCGATGGACA
GCGCGATTCTA: CGCGATTCTAT
GCGCGTTGGGA: CGCGTTGGGAG
GCGCTCCGGTT: CGCTCCGGTTG
GCGCTGAGACA: CGCTGAGACAT
GCGGAACTAGT: CGGAACTAGTG
GCGGAAGTTCT: CGGAAGTTCTC
GCGGCCATCAG: CGGCCATCAGG
GCGGCTGGGTT: CGGCTGGGTTC
GCGGGAACATT: CGGGAACATTA
GCGGGCGCGAT: CGGGCGCGATT
GCGGTCTCGGG: CGGTCTCGGGT
GCGTAAGGAGG: CGTAAGGAGGA
GCGTACTCGTA: CGTACTCGTAG
GCGTCGCTGAA: CGTCGCTGAAC
GCGTGTCGGTT: CGTGTCGGTTG
GCGTTAGTCTC: CGTTAGTCTCC
GCGTTGGGAGA: CGTTGGGAGAT
GCTAAGCGGTC: CTAAGCGGTCT
GCTACATTGAT: CTACATTGATT
GCTACGAGTGG: CTACGAGTGGG
GCTACGTAAGT: CTACGTAAGTC
GCTAGGCCAAG: CTAGGCCAAGT
GCTATGCAGTT: CTATGCAGTTA
GCTATGCCATA: CTATGCCATAC
GCTATTATAAG: CTATTATAAGG
GCTATTTTGGA: CTATTTTGGAA
GCTCCGGTTGG: CTCCGGTTGGT
GCTCCTCGGCG: CTCCTCGGCGG
GCTCGATCTTA: CTCGATCTTAC
GCTCGCATATT: CTCGCATATTG
GCTCTAGGATT: CTCTAGGATTC
GCTCTAGGTCG: CTCTAGGTCGC
GCTCTAGTGGA: CTCTAGTGGAG
GCTGAACCGCA: CTGAACCGCAG
GCTGAAGTTCA: CTGAAGTTCAG
GCTGAGACATT: CTGAGACATTC
GCTGAGCCCAC: CTGAGCCCACT
GCTGCCCGACT: CTGCCCGACTT
GCTGCCTCGCG: CTGCCTCGCGT
GCTGCGGAAGT: CTGCGGAAGTT
GCTGGAACTAT: CTGGAACTATC
GCTGGGTTCCG: CTGGGTTCCGT
GCTGGTTCTTG: CTGGTTCTTGG
GCTGTCGCGAT: CTGTCGCGATA
GCTTAAAGTTT: CTTAAAGTTTA
GCTTAACTCCA: CTTAACTCCAC
GCTTACTTAAA: CTTACTTAAAG
GCTTCTATGGA: CTTCTATGGAG
GCTTGATAAAG: CTTGATAAAGC
GCTTGGGTAGT: CTTGGGTAGTG
GCTTGTGCAAT: CTTGTGCAATT
GCTTTAATTTA: CTTTAATTTAC
GGAAAACCAAT: GAAAACCAATT
GGAAAGTGTAG: GAAAGTGTAGT
GGAACATTATT: GAACATTATTC
GGAACTAGTGG: GAACTAGTGGC
GGAACTATCTC: GAACTATCTCA
GGAAGTACAAC: GAAGTACAACT
GGAAGTCCTTC: GAAGTCCTTCG
GGAAGTTCTCT: GAAGTTCTCTG
GGAATAGAGAA: GAATAGAGAAA
GGAATGCTTCT: GAATGCTTCTA
GGACACGTGCA: GACACGTGCAT
GGACGAAACCC: GACGAAACCCC
GGACTTCGTAT: GACTTCGTATT
GGACTTTAGCT: GACTTTAGCTT
GGAGAAAGTTG: GAGAAAGTTGT
GGAGAAGCAAG: GAGAAGCAAGT
GGAGAATCCTC: GAGAATCCTCT
GGAGATATGAA: GAGATATGAAA
GGAGGACTTTA: GAGGACTTTAG
GGAGGAGTGTT: GAGGAGTGTTA
GGAGGCGTCGC: GAGGCGTCGCT
GGAGGCTAAGC: GAGGCTAAGCG
GGAGGGGAGTT: GAGGGGAGTTA
GGAGGTTGAGG: GAGGTTGAGGA
GGAGTCACTCA: GAGTCACTCAT
GGAGTCATTAT: GAGTCATTATC
GGAGTCTAGCA: GAGTCTAGCAA
GGAGTGCTACG: GAGTGCTACGT
GGAGTGTAAGC: GAGTGTAAGCT
GGAGTGTTACA: GAGTGTTACAC
GGAGTTAAGCA: GAGTTAAGCAC
GGATATTCTGT: GATATTCTGTG
GGATTAGAAAA: GATTAGAAAAT
GGATTCGACGG: GATTCGACGGT
GGATTCGTCTA: GATTCGTCTAG
GGATTGCTGCG: GATTGCTGCGG
GGATTTTCACC: GATTTTCACCG
GGCAACCTCCG: GCAACCTCCGC
GGCAATGCTCT: GCAATGCTCTA
GGCACCTTGGT: GCACCTTGGTT
GGCACGAGTAG: GCACGAGTAGA
GGCACTGCTCT: GCACTGCTCTA
GGCAGGATTGC: GCAGGATTGCT
GGCAGTCAACC: GCAGTCAACCA
GGCAGTGAAAG: GCAGTGAAAGG
GGCATATTGCA: GCATATTGCAA
GGCATTGAATA: GCATTGAATAG
GGCCAAACTAA: GCCAAACTAAG
GGCCAAGTTCT: GCCAAGTTCTT
GGCCATCAGGG: GCCATCAGGGA
GGCCCAGATGC: GCCCAGATGCT
GGCCCGGTTTT: GCCCGGTTTTA
GGCCCTAAGAG: GCCCTAAGAGC
GGCCGGGCGCG: GCCGGGCGCGT
GGCCTCTAACA: GCCTCTAACAA
GGCGAACGCAG: GCGAACGCAGT
GGCGAGGAATG: GCGAGGAATGC
GGCGCAATTAA: GCGCAATTAAT
GGCGCAGACCG: GCGCAGACCGC
GGCGCGATTCT: GCGCGATTCTA
GGCGCGTTGGG: GCGCGTTGGGA
GGCGGCCATCA: GCGGCCATCAG
GGCGTAAGGAG: GCGTAAGGAGG
GGCGTACTCGT: GCGTACTCGTA
GGCGTCGCTGA: GCGTCGCTGAA
GGCTAAGCGGT: GCTAAGCGGTC
GGCTACATTGA: GCTACATTGAT
GGCTCTAGGTC: GCTCTAGGTCG
GGCTGAGCCCA: GCTGAGCCCAC
GGCTGGGTTCC: GCTGGGTTCCG
GGGAAAACCAA: GGAAAACCAAT
GGGAACATTAT: GGAACATTATT
GGGACTTCGTA: GGACTTCGTAT
GGGAGAATCCT: GGAGAATCCTC
GGGAGATATGA: GGAGATATGAA
GGGAGGGGAGT: GGAGGGGAGTT
GGGAGGTTGAG: GGAGGTTGAGG
GGGAGTCACTC: GGAGTCACTCA
GGGAGTCTAGC: GGAGTCTAGCA
GGGAGTTAAGC: GGAGTTAAGCA
GGGATTCGTCT: GGATTCGTCTA
GGGATTTTCAC: GGATTTTCACC
GGGCAGGATTG: GGCAGGATTGC
GGGCCCAGATG: GGCCCAGATGC
GGGCCCGGTTT: GGCCCGGTTTT
GGGCCTCTAAC: GGCCTCTAACA
GGGCGCGATTC: GGCGCGATTCT
GGGCGCGTTGG: GGCGCGTTGGG
GGGGAGGGGAG: GGGAGGGGAGT
GGGGAGTTAAG: GGGAGTTAAGC
GGGGCCTCTAA: GGGCCTCTAAC
GGGGGTTACAA: GGGGTTACAAT
GGGGTAGGTAG: GGGTAGGTAGT
GGGGTTACAAT: GGGTTACAATT
GGGTAGGTAGT: GGTAGGTAGTC
GGGTAGTGCTT: GGTAGTGCTTG
GGGTTACAATT: GGTTACAATTG
GGGTTCCGTAT: GGTTCCGTATT
GGGTTGTATGG: GGTTGTATGGC
GGTAGACCTTA: GTAGACCTTAT
GGTAGCAATGC: GTAGCAATGCA
GGTAGGTAGTC: GTAGGTAGTCT
GGTAGTCTTGT: GTAGTCTTGTT
GGTAGTGCTTG: GTAGTGCTTGA
GGTCCCGCGGG: GTCCCGCGGGC
GGTCGCCATCT: GTCGCCATCTC
GGTCTCGGGTT: GTCTCGGGTTG
GGTCTGACTTC: GTCTGACTTCT
GGTCTTATTCA: GTCTTATTCAC
GGTGAGCGCAA: GTGAGCGCAAA
GGTGATGCACA: GTGATGCACAA
GGTGGCAGTGA: GTGGCAGTGAA
GGTGTTAGGCA: GTGTTAGGCAC
GGTTACAATTG: GTTACAATTGG
GGTTATACGCT: GTTATACGCTC
GGTTCCGTATT: GTTCCGTATTC
GGTTCTTGGCA: GTTCTTGGCAA
GGTTGAGGATA: GTTGAGGATAT
GGTTGAGGCCC: GTTGAGGCCCT
GGTTGCTGCCC: GTTGCTGCCCG
GGTTGGTGATG: GTTGGTGATGC
GGTTGTATGGC: GTTGTATGGCG
GGTTTATCATA: GTTTATCATAT
GGTTTGCAACC: GTTTGCAACCT
GGTTTTAATTT: GTTTTAATTTA
GTAAGCACGTT: TAAGCACGTTA
GTAAGCTTGGG: TAAGCTTGGGT
GTAAGGAGGAG: TAAGGAGGAGT
GTAAGTCCCAT: TAAGTCCCATA
GTAAGTGGACG: TAAGTGGACGA
GTAATCATTGC: TAATCATTGCC
GTACAACTTCT: TACAACTTCTA
GTACATTAGAA: TACATTAGAAT
GTACCTGCATC: TACCTGCATCT
GTACTCGTAGG: TACTCGTAGGT
GTAGAACCAGG: TAGAACCAGGA
GTAGAATGAAA: TAGAATGAAAT
GTAGACAGGAG: TAGACAGGAGG
GTAGACCTTAT: TAGACCTTATT
GTAGATTTTGG: TAGATTTTGGT
GTAGCAATGCA: TAGCAATGCAA
GTAGGTAGTCT: TAGGTAGTCTT
GTAGGTGTTAG: TAGGTGTTAGG
GTAGTCCTCCG: TAGTCCTCCGA
GTAGTCTTGTT: TAGTCTTGTTA
GTAGTGCTTGA: TAGTGCTTGAT
GTATCACTTCA: TATCACTTCAC
GTATGAAGTAT: TATGAAGTATT
GTATGGCGTAA: TATGGCGTAAG
GTATTCTTGTT: TATTCTTGTTC
GTATTGACAAG: TATTGACAAGA
GTATTGGCACG: TATTGGCACGA
GTCAACCACAG: TCAACCACAGA
GTCACTCATTC: TCACTCATTCT
GTCAGCTGGTT: TCAGCTGGTTC
GTCATGGGCCC: TCATGGGCCCG
GTCATTATCAG: TCATTATCAGG
GTCCAACTATA: TCCAACTATAA
GTCCCATAAGC: TCCCATAAGCA
GTCCCGCGGGC: TCCCGCGGGCG
GTCCGCGCTCC: TCCGCGCTCCG
GTCCTCCGATT: TCCTCCGATTA
GTCCTTCGGGA: TCCTTCGGGAA
GTCGAATATAT: TCGAATATATA
GTCGCCATCTC: TCGCCATCTCC
GTCGCGATAGG: TCGCGATAGGT
GTCGCTGAACC: TCGCTGAACCG
GTCGGCTACAT: TCGGCTACATT
GTCGGTTGAGG: TCGGTTGAGGC
GTCGTAGACAG: TCGTAGACAGG
GTCTAGCAAAC: TCTAGCAAACA
GTCTAGCGAGA: TCTAGCGAGAG
GTCTCCTCCTC: TCTCCTCCTCA
GTCTCGGGTTG: TCTCGGGTTGT
GTCTGACTTCT: TCTGACTTCTA
GTCTGGGCAGG: TCTGGGCAGGA
GTCTTATTCAC: TCTTATTCACA
GTCTTGCCAGG: TCTTGCCAGGA
GTCTTGTTAGC: TCTTGTTAGCT
GTGAAACCCGG: TGAAACCCGGT
GTGAAAGGAAA: TGAAAGGAAAG
GTGAAGTCGAA: TGAAGTCGAAT
GTGAATATCCC: TGAATATCCCC
GTGACTTGCAG: TGACTTGCAGT
GTGAGCGCAAA: TGAGCGCAAAA
GTGATGCACAA: TGATGCACAAA
GTGCAATTACG: TGCAATTACGG
GTGCAATTTTC: TGCAATTTTCC
GTGCACTAAAT: TGCACTAAATA
GTGCATTCCCT: TGCATTCCCTC
GTGCGAGGTTA: TGCGAGGTTAT
GTGCGCTGAGA: TGCGCTGAGAC
GTGCTACGTAA: TGCTACGTAAG
GTGCTATTATA: TGCTATTATAA
GTGCTTGATAA: TGCTTGATAAA
GTGGACGAAAC: TGGACGAAACC
GTGGAGGCGTC: TGGAGGCGTCG
GTGGCAGTGAA: TGGCAGTGAAA
GTGGCTCTAGG: TGGCTCTAGGT
GTGGCTGAGCC: TGGCTGAGCCC
GTGGGAGTCTA: TGGGAGTCTAG
GTGGGGTAGGT: TGGGGTAGGTA
GTGTAAGCTTG: TGTAAGCTTGG
GTGTAGTCCTC: TGTAGTCCTCC
GTGTCGGTTGA: TGTCGGTTGAG
GTGTTACACCG: TGTTACACCGT
GTGTTAGGCAC: TGTTAGGCACC
GTTAAAACGTT: TTAAAACGTTA
GTTAAAGACAG: TTAAAGACAGC
GTTAAATTTGG: TTAAATTTGGG
GTTAAGCACGG: TTAAGCACGGT
GTTACAATTGG: TTACAATTGGC
GTTACACCGTG: TTACACCGTGC
GTTACCTCTGT: TTACCTCTGTC
GTTAGCTGCCT: TTAGCTGCCTC
GTTAGGCACCT: TTAGGCACCTT
GTTAGTCTCCT: TTAGTCTCCTC
GTTATACGCTC: TTATACGCTCC
GTTCAGGTCTT: TTCAGGTCTTA
GTTCAGTGCTA: TTCAGTGCTAT
GTTCCGTATTC: TTCCGTATTCT
GTTCTCTGCGT: TTCTCTGCGTG
GTTCTTATCGT: TTCTTATCGTA
GTTCTTGGCAA: TTCTTGGCAAC
GTTGAGGATAT: TTGAGGATATT
GTTGAGGCCCT: TTGAGGCCCTA
GTTGCCTTATT: TTGCCTTATTC
GTTGCTGCCCG: TTGCTGCCCGA
GTTGGGAGATA: TTGGGAGATAT
GTTGGTGATGC: TTGGTGATGCA
GTTGTATGGCG: TTGTATGGCGT
GTTGTCAGCTG: TTGTCAGCTGG
GTTTAAGTAAT: TTTAAGTAATC
GTTTATCATAT: TTTATCATATG
GTTTCGTGAAG: TTTCGTGAAGT
GTTTGCAACCT: TTTGCAACCTA
GTTTTAATTTA: TTTTAATTTAG
TAAAACGTTAC: AAAACGTTACC
TAAAATACGGG: AAAATACGGGG
TAAAGACAGCC: AAAGACAGCCG
TAAAGCCTTAT: AAAGCCTTATA
TAAAGCTGGAA: AAAGCTGGAAC
TAAAGTTTAAG: AAAGTTTAAGT
TAAATAAGTGA: AAATAAGTGAA
TAAATTTGGGA: AAATTTGGGAC
TAACAAACATC: AACAAACATCC
TAACAAGGCCG: AACAAGGCCGG
TAACGATCCCT: AACGATCCCTG
TAACTCACTGC: AACTCACTGCC
TAACTCCACGA: AACTCCACGAG
TAAGAGCTCGC: AAGAGCTCGCA
TAAGATGGCAT: AAGATGGCATT
TAAGCACGGTA: AAGCACGGTAG
TAAGCACGTTA: AAGCACGTTAA
TAAGCAGCTAT: AAGCAGCTATT
TAAGCAGGCAT: AAGCAGGCATA
TAAGCCGCTAG: AAGCCGCTAGG
TAAGCGGTCTC: AAGCGGTCTCG
TAAGCTTGGGT: AAGCTTGGGTA
TAAGGAGGAGT: AAGGAGGAGTG
TAAGGAGTGCT: AAGGAGTGCTA
TAAGGCAGTCA: AAGGCAGTCAA
TAAGTAATCAT: AAGTAATCATT
TAAGTCCCATA: AAGTCCCATAA
TAAGTGAATAT: AAGTGAATATC
TAAGTGGACGA: AAGTGGACGAA
TAAGTTGCCTT: AAGTTGCCTTA
TAAGTTTCGTG: AAGTTTCGTGA
TAATATGGAGA: AATATGGAGAA
TAATCATTGCC: AATCATTGCCC
TAATGACGCAG: AATGACGCAGA
TAATGACGCAT: AATGACGCATG
TAATGACGTCG: AATGACGTCGG
TAATTGCCACT: AATTGCCACTT
TAATTTACCGG: AATTTACCGGC
TAATTTAGATA: AATTTAGATAA
TACAACTTCTA: ACAACTTCTAG
TACAATTGGCG: ACAATTGGCGC
TACACCGTGCA: ACACCGTGCAC
TACATTAGAAT: ACATTAGAATT
TACATTGATTT: ACATTGATTTA
TACCCCCATAG: ACCCCCATAGT
TACCGATTTAG: ACCGATTTAGT
TACCGGCGAAC: ACCGGCGAACG
TACCTCTGTCC: ACCTCTGTCCG
TACCTGCATCT: ACCTGCATCTG
TACGAGACTTT: ACGAGACTTTC
TACGAGTGGGA: ACGAGTGGGAG
TACGCATACGA: ACGCATACGAG
TACGCTCCTCG: ACGCTCCTCGG
TACGCTTAACT: ACGCTTAACTC
TACGGGAGGTT: ACGGGAGGTTG
TACGGGGCCTC: ACGGGGCCTCT
TACGGGGGTTA: ACGGGGGTTAC
TACGTAAGTCC: ACGTAAGTCCC
TACGTCGTAGA: ACGTCGTAGAC
TACTAGTACCT: ACTAGTACCTG
TACTCGTAGGT: ACTCGTAGGTG
TACTTAAAGCC: ACTTAAAGCCT
TAGAAAATCGC: AGAAAATCGCC
TAGAACCAGGA: AGAACCAGGAA
TAGAACTAGGG: AGAACTAGGGA
TAGAATCGAGC: AGAATCGAGCA
TAGAATGAAAT: AGAATGAAATC
TAGAATTAACA: AGAATTAACAA
TAGACAGGAGG: AGACAGGAGGC
TAGACCTTATT: AGACCTTATTA
TAGAGAAATTA: AGAGAAATTAG
TAGATAACGAT: AGATAACGATC
TAGATTTTGGT: AGATTTTGGTG
TAGCAAACATC: AGCAAACATCC
TAGCAATGCAA: AGCAATGCAAC
TAGCACATGTA: AGCACATGTAT
TAGCGAGAGAG: AGCGAGAGAGA
TAGCGCGATGG: AGCGCGATGGA
TAGCTCGATCT: AGCTCGATCTT
TAGCTGCCTCG: AGCTGCCTCGC
TAGCTTAAAGT: AGCTTAAAGTT
TAGGATTCGAC: AGGATTCGACG
TAGGCACCTTG: AGGCACCTTGG
TAGGCCAAGTT: AGGCCAAGTTC
TAGGGAGAATC: AGGGAGAATCC
TAGGGATTTTC: AGGGATTTTCA
TAGGGCCCAGA: AGGGCCCAGAT
TAGGTAGTCTT: AGGTAGTCTTG
TAGGTCGCCAT: AGGTCGCCATC
TAGGTCTGACT: AGGTCTGACTT
TAGGTGTTAGG: AGGTGTTAGGC
TAGGTTTATCA: AGGTTTATCAT
TAGTACCTGCA: AGTACCTGCAT
TAGTCATGGGC: AGTCATGGGCC
TAGTCCTCCGA: AGTCCTCCGAT
TAGTCTCCTCC: AGTCTCCTCCT
TAGTCTTGTTA: AGTCTTGTTAG
TAGTGAAACCC: AGTGAAACCCG
TAGTGACTTGC: AGTGACTTGCA
TAGTGCTTGAT: AGTGCTTGATA
TAGTGGAGGCG: AGTGGAGGCGT
TAGTGGCTCTA: AGTGGCTCTAG
TAGTGGGGTAG: AGTGGGGTAGG
TATAACTCACT: ATAACTCACTG
TATAAGGAGTG: ATAAGGAGTGC
TATAATTGCCA: ATAATTGCCAC
TATACGCTCCT: ATACGCTCCTC
TATAGAATCGA: ATAGAATCGAG
TATAGGTTTAT: ATAGGTTTATC
TATATAGGTTT: ATATAGGTTTA
TATCACTTCAC: ATCACTTCACT
TATCAGGGGAG: ATCAGGGGAGG
TATCATAAGGC: ATCATAAGGCA
TATCATATGGC: ATCATATGGCG
TATCCCCGCGG: ATCCCCGCGGG
TATCGCTACGA: ATCGCTACGAG
TATCGTAGAAT: ATCGTAGAATG
TATCTCAGTTA: ATCTCAGTTAA
TATGAAAGCGA: ATGAAAGCGAT
TATGAAGTATT: ATGAAGTATTG
TATGCAGTTAA: ATGCAGTTAAA
TATGCATCTGA: ATGCATCTGAT
TATGCCATACG: ATGCCATACGG
TATGGAGAAGC: ATGGAGAAGCA
TATGGAGTCAT: ATGGAGTCATT
TATGGCGAGGA: ATGGCGAGGAA
TATGGCGTAAG: ATGGCGTAAGG
TATTATAAGGA: ATTATAAGGAG
TATTATTGCTT: ATTATTGCTTA
TATTCACAACT: ATTCACAACTT
TATTCATTCAT: ATTCATTCATC
TATTCTAGTGG: ATTCTAGTGGG
TATTCTGTGCG: ATTCTGTGCGA
TATTCTTGTTC: ATTCTTGTTCA
TATTCTTTCGG: ATTCTTTCGGT
TATTGACAAGA: ATTGACAAGAA
TATTGCAATTT: ATTGCAATTTA
TATTGCTTACT: ATTGCTTACTT
TATTGGCACGA: ATTGGCACGAG
TATTGTACATT: ATTGTACATTA
TATTTTGGAAG: ATTTTGGAAGT
TATTTTGGCAA: ATTTTGGCAAT
TCAAATACGCT: CAAATACGCTT
TCAACACGAGT: CAACACGAGTG
TCAACCACAGA: CAACCACAGAG
TCACAACTTGT: CACAACTTGTG
TCACCGCTGTC: CACCGCTGTCG
TCACGGAATAG: CACGGAATAGA
TCACTAATGAC: CACTAATGACG CACTAATGACG
TCACTCATTCT: CACTCATTCTT
TCACTGCCCCT: CACTGCCCCTA
TCACTTCACTA: CACTTCACTAA
TCAGCTGGTTC: CAGCTGGTTCT
TCAGGGGAGGG: CAGGGGAGGGG
TCAGGTCTTAT: CAGGTCTTATT
TCAGTGCTATT: CAGTGCTATTA
TCAGTTAAATT: CAGTTAAATTT
TCATAAGGCAG: CATAAGGCAGT
TCATATGCATC: CATATGCATCT
TCATATGGCGA: CATATGGCGAG
TCATCTATTTT: CATCTATTTTG
TCATGCTGAAG: CATGCTGAAGT
TCATGGGCCCG: CATGGGCCCGG
TCATTATCAGG: CATTATCAGGG
TCATTCATATG: CATTCATATGC
TCATTCATCTA: CATTCATCTAT
TCATTCTTGGA: CATTCTTGGAG
TCATTGCCCTT: CATTGCCCTTT
TCCAACTATAA: CCAACTATAAT
TCCACGAGAAC: CCACGAGAACT
TCCAGCCGCAT: CCAGCCGCATT
TCCCATAAGCA: CCCATAAGCAG
TCCCCGCGGGA: CCCCGCGGGAA
TCCCCTTTGGG: CCCCTTTGGGA
TCCCGCGGGCG: CCCGCGGGCGC
TCCCTCGATGA: CCCTCGATGAT
TCCCTGCGGCT: CCCTGCGGCTG
TCCGATTAAGC: CCGATTAAGCC
TCCGCAAGAAT: CCGCAAGAATG
TCCGCGCTCCG: CCGCGCTCCGG
TCCGGTTGGTG: CCGGTTGGTGA
TCCGTATCACT: CCGTATCACTT
TCCGTATTCTT: CCGTATTCTTG
TCCTAGGGATT: CCTAGGGATTT
TCCTCAACACG: CCTCAACACGA
TCCTCACGGAA: CCTCACGGAAT
TCCTCCGATTA: CCTCCGATTAA
TCCTCCTCAAC: CCTCCTCAACA
TCCTCGGCGGC: CCTCGGCGGCC
TCCTCTCCAGC: CCTCTCCAGCC
TCCTCTTTGGC: CCTCTTTGGCC
TCCTGTAGAAC: CCTGTAGAACC
TCCTTCGGGAA: CCTTCGGGAAA
TCGAATATATA: CGAATATATAG
TCGACGGTCCC: CGACGGTCCCG
TCGAGCAGGTG: CGAGCAGGTGA
TCGATCTTACT: CGATCTTACTA
TCGATGATCAA: CGATGATCAAA
TCGCATATTGT: CGCATATTGTA
TCGCCATCTCC: CGCCATCTCCT
TCGCCTCCTCT: CGCCTCCTCTT
TCGCGATAGGT: CGCGATAGGTC
TCGCGTTAGTC: CGCGTTAGTCT
TCGCTACGAGT: CGCTACGAGTG
TCGCTGAACCG: CGCTGAACCGC
TCGGAGTGTAA: CGGAGTGTAAG
TCGGCGGCCAT: CGGCGGCCATC
TCGGCTACATT: CGGCTACATTG
TCGGGAAAACC: CGGGAAAACCA
TCGGGTTGTAT: CGGGTTGTATG
TCGGTAGCAAT: CGGTAGCAATG
TCGGTTGAGGC: CGGTTGAGGCC
TCGTAGAATGA: CGTAGAATGAA
TCGTAGACAGG: CGTAGACAGGA
TCGTAGGTGTT: CGTAGGTGTTA
TCGTATTGACA: CGTATTGACAA
TCGTCTAGCGA: CGTCTAGCGAG
TCGTCTGGGCA: CGTCTGGGCAG
TCGTGAAGTCG: CGTGAAGTCGA
TCTAACAAGGC: CTAACAAGGCC
TCTAAGTTGCC: CTAAGTTGCCT
TCTAGCAAACA: CTAGCAAACAT
TCTAGCGAGAG: CTAGCGAGAGA
TCTAGCTCGAT: CTAGCTCGATC
TCTAGGATTCG: CTAGGATTCGA
TCTAGGGCCCA: CTAGGGCCCAG
TCTAGGTCGCC: CTAGGTCGCCA
TCTAGTGGAGG: CTAGTGGAGGC
TCTAGTGGGGT: CTAGTGGGGTA
TCTATCGCTAC: CTATCGCTACG
TCTATGGAGTC: CTATGGAGTCA
TCTATTTTGGC: CTATTTTGGCA
TCTCAGTTAAA: CTCAGTTAAAT
TCTCATTCATA: CTCATTCATAT
TCTCCAGCCGC: CTCCAGCCGCA
TCTCCTAGGGA: CTCCTAGGGAT
TCTCCTCCTCA: CTCCTCCTCAA
TCTCGGGTTGT: CTCGGGTTGTA
TCTCTGCGTGT: CTCTGCGTGTC
TCTGAATAGTG: CTGAATAGTGA
TCTGACTTCTA: CTGACTTCTAG
TCTGATTGATC: CTGATTGATCT
TCTGCGTGTCG: CTGCGTGTCGG
TCTGGGCAGGA: CTGGGCAGGAT
TCTGTCCGCGC: CTGTCCGCGCT
TCTGTGCGAGG: CTGTGCGAGGT
TCTTACTAGTA: CTTACTAGTAC
TCTTATCGTAG: CTTATCGTAGA
TCTTATTCACA: CTTATTCACAA
TCTTGCCAGGA: CTTGCCAGGAG
TCTTGGAGAAA: CTTGGAGAAAG
TCTTGGCAACC: CTTGGCAACCT
TCTTGTTAGCT: CTTGTTAGCTG
TCTTGTTCAGG: CTTGTTCAGGT
TCTTTCGGTAG: CTTTCGGTAGC
TCTTTGGCCAA: CTTTGGCCAAA
TGAAACCCGGT: GAAACCCGGTT
TGAAAGCGATG: GAAAGCGATGG
TGAAAGGAAAG: GAAAGGAAAGT
TGAAATCTCAT: GAAATCTCATT
TGAACCGCAGA: GAACCGCAGAT
TGAAGCTTGTG: GAAGCTTGTGC
TGAAGTATTGG: GAAGTATTGGC
TGAAGTCGAAT: GAAGTCGAATA
TGAAGTTCAGT: GAAGTTCAGTG
TGAATAGCACA: GAATAGCACAT
TGAATAGTGAC: GAATAGTGACT
TGAATATCCCC: GAATATCCCCG
TGACAAGAACT: GACAAGAACTG
TGACCCCCTAT: GACCCCCTATA
TGACCGGGAGT: GACCGGGAGTC
TGACGCAGACA: GACGCAGACAG
TGACGCATGCT: GACGCATGCTA
TGACGTCGGCT: GACGTCGGCTA
TGACTTCTAGG: GACTTCTAGGG
TGACTTGCAGT: GACTTGCAGTG
TGAGACATTCG: GAGACATTCGT
TGAGCCCACTA: GAGCCCACTAC
TGAGCGCAAAA: GAGCGCAAAAG
TGAGGATATTC: GAGGATATTCT
TGAGGCCCTAA: GAGGCCCTAAG
TGATAAAATAC: GATAAAATACG
TGATAAAGCTG: GATAAAGCTGG
TGATCAAATAC: GATCAAATACG
TGATCTAAGTT: GATCTAAGTTG
TGATGCACAAA: GATGCACAAAA
TGATTGATCTA: GATTGATCTAA
TGATTTATTCT: GATTTATTCTT
TGCAACCTAAT: GCAACCTAATA
TGCAACTGCAC: GCAACTGCACG
TGCAATTACGG: GCAATTACGGG
TGCAATTTAGA: GCAATTTAGAA
TGCAATTTTCC: GCAATTTTCCT
TGCACAAAATT: GCACAAAATTC
TGCACGGCGTA: GCACGGCGTAC
TGCACTAAATA: GCACTAAATAA
TGCAGTGCGCT: GCAGTGCGCTG
TGCAGTTAAAG: GCAGTTAAAGA
TGCATCTGAAT: GCATCTGAATA
TGCATCTGATT: GCATCTGATTG
TGCATTCCCTC: GCATTCCCTCG
TGCCACTTAAG: GCCACTTAAGT
TGCCAGGAGGA: GCCAGGAGGAC
TGCCATACGGG: GCCATACGGGA
TGCCCCTACGT: GCCCCTACGTC
TGCCCGACTTT: GCCCGACTTTG
TGCCCTTTGAC: GCCCTTTGACC
TGCCTCGCGTT: GCCTCGCGTTA
TGCCTTATTCT: GCCTTATTCTA
TGCGAGGTTAT: GCGAGGTTATA
TGCGCTGAGAC: GCGCTGAGACA
TGCGGAAGTTC: GCGGAAGTTCT
TGCGGCTGGGT: GCGGCTGGGTT
TGCGTGTCGGT: GCGTGTCGGTT
TGCTACGTAAG: GCTACGTAAGT
TGCTATGCAGT: GCTATGCAGTT
TGCTATTATAA: GCTATTATAAG
TGCTCTAGGAT: GCTCTAGGATT
TGCTCTAGTGG: GCTCTAGTGGA
TGCTGAAGTTC: GCTGAAGTTCA
TGCTGCCCGAC: GCTGCCCGACT
TGCTGCGGAAG: GCTGCGGAAGT
TGCTTACTTAA: GCTTACTTAAA
TGCTTCTATGG: GCTTCTATGGA
TGCTTGATAAA: GCTTGATAAAG
TGCTTTAATTT: GCTTTAATTTA
TGGAACTATCT: GGAACTATCTC
TGGAAGTCCTT: GGAAGTCCTTC
TGGACACGTGC: GGACACGTGCA
TGGACGAAACC: GGACGAAACCC
TGGAGAAAGTT: GGAGAAAGTTG
TGGAGAAGCAA: GGAGAAGCAAG
TGGAGGCGTCG: GGAGGCGTCGC
TGGAGTCATTA: GGAGTCATTAT
TGGATTAGAAA: GGATTAGAAAA
TGGCAACCTCC: GGCAACCTCCG
TGGCAATGCTC: GGCAATGCTCT
TGGCACGAGTA: GGCACGAGTAG
TGGCACTGCTC: GGCACTGCTCT
TGGCAGTGAAA: GGCAGTGAAAG
TGGCATTGAAT: GGCATTGAATA
TGGCCAAACTA: GGCCAAACTAA
TGGCGAGGAAT: GGCGAGGAATG
TGGCGCAATTA: GGCGCAATTAA
TGGCGCAGACC: GGCGCAGACCG
TGGCGTAAGGA: GGCGTAAGGAG
TGGCTCTAGGT: GGCTCTAGGTC
TGGCTGAGCCC: GGCTGAGCCCA
TGGGACTTCGT: GGGACTTCGTA
TGGGAGATATG: GGGAGATATGA
TGGGAGTCTAG: GGGAGTCTAGC
TGGGATTCGTC: GGGATTCGTCT
TGGGCAGGATT: GGGCAGGATTG
TGGGCCCGGTT: GGGCCCGGTTT
TGGGGTAGGTA: GGGGTAGGTAG
TGGGTAGTGCT: GGGTAGTGCTT
TGGGTTCCGTA: GGGTTCCGTAT
TGGTGATGCAC: GGTGATGCACA
TGGTGGCAGTG: GGTGGCAGTGA
TGGTTCTTGGC: GGTTCTTGGCA
TGGTTTGCAAC: GGTTTGCAACC
TGTAAGCTTGG: GTAAGCTTGGG
TGTACATTAGA: GTACATTAGAA
TGTAGAACCAG: GTAGAACCAGG
TGTAGTCCTCC: GTAGTCCTCCG
TGTATGAAGTA: GTATGAAGTAT
TGTATGGCGTA: GTATGGCGTAA
TGTCAGCTGGT: GTCAGCTGGTT
TGTCCAACTAT: GTCCAACTATA
TGTCCGCGCTC: GTCCGCGCTCC
TGTCGCGATAG: GTCGCGATAGG
TGTCGGTTGAG: GTCGGTTGAGG
TGTGCAATTTT: GTGCAATTTTC
TGTGCGAGGTT: GTGCGAGGTTA
TGTGGCTGAGC: GTGGCTGAGCC
TGTTACACCGT: GTTACACCGTG
TGTTAGCTGCC: GTTAGCTGCCT
TGTTAGGCACC: GTTAGGCACCT
TGTTCAGGTCT: GTTCAGGTCTT
TTAAAACGTTA: TAAAACGTTAC
TTAAAGACAGC: TAAAGACAGCC
TTAAAGCCTTA: TAAAGCCTTAT
TTAAAGTTTAA: TAAAGTTTAAG
TTAAATTTGGG: TAAATTTGGGA
TTAACAAACAT: TAACAAACATC
TTAACTCCACG: TAACTCCACGA
TTAAGATGGCA: TAAGATGGCAT
TTAAGCACGGT: TAAGCACGGTA
TTAAGCCGCTA: TAAGCCGCTAG
TTAAGTAATCA: TAAGTAATCAT
TTAAGTTTCGT: TAAGTTTCGTG
TTAATGACGTC: TAATGACGTCG
TTAATTTACCG: TAATTTACCGG
TTAATTTAGAT: TAATTTAGATA
TTACAATTGGC: TACAATTGGCG
TTACACCGTGC: TACACCGTGCA
TTACCGGCGAA: TACCGGCGAAC
TTACCTCTGTC: TACCTCTGTCC
TTACGGGGCCT: TACGGGGCCTC
TTACTAGTACC: TACTAGTACCT
TTACTTAAAGC: TACTTAAAGCC
TTAGAAAATCG: TAGAAAATCGC
TTAGAACTAGG: TAGAACTAGGG
TTAGAATTAAC: TAGAATTAACA
TTAGATAACGA: TAGATAACGAT
TTAGCGCGATG: TAGCGCGATGG
TTAGCTGCCTC: TAGCTGCCTCG
TTAGCTTAAAG: TAGCTTAAAGT
TTAGGCACCTT: TAGGCACCTTG
TTAGTCATGGG: TAGTCATGGGC
TTAGTCTCCTC: TAGTCTCCTCC
TTATAAGGAGT: TATAAGGAGTG
TTATACGCTCC: TATACGCTCCT
TTATAGAATCG: TATAGAATCGA
TTATCAGGGGA: TATCAGGGGAG
TTATCATAAGG: TATCATAAGGC
TTATCATATGG: TATCATATGGC
TTATCGTAGAA: TATCGTAGAAT
TTATTATTGCT: TATTATTGCTT
TTATTCACAAC: TATTCACAACT
TTATTCATTCA: TATTCATTCAT
TTATTCTAGTG: TATTCTAGTGG
TTATTCTTTCG: TATTCTTTCGG
TTATTGCTTAC: TATTGCTTACT
TTCACAACTTG: TCACAACTTGT
TTCACCGCTGT: TCACCGCTGTC
TTCACTAATGA: TCACTAATGAC TCACTAATGAC
TTCAGGTCTTA: TCAGGTCTTAT
TTCAGTGCTAT: TCAGTGCTATT
TTCATATGCAT: TCATATGCATC
TTCATCTATTT: TCATCTATTTT
TTCATGCTGAA: TCATGCTGAAG
TTCATTCATCT: TCATTCATCTA
TTCCCTCGATG: TCCCTCGATGA
TTCCGTATTCT: TCCGTATTCTT
TTCCTCACGGA: TCCTCACGGAA
TTCGACGGTCC: TCGACGGTCCC
TTCGGAGTGTA: TCGGAGTGTAA
TTCGGGAAAAC: TCGGGAAAACC
TTCGGTAGCAA: TCGGTAGCAAT
TTCGTATTGAC: TCGTATTGACA
TTCGTCTAGCG: TCGTCTAGCGA
TTCGTCTGGGC: TCGTCTGGGCA
TTCGTGAAGTC: TCGTGAAGTCG
TTCTAGCTCGA: TCTAGCTCGAT
TTCTAGGGCCC: TCTAGGGCCCA
TTCTAGTGGGG: TCTAGTGGGGT
TTCTATCGCTA: TCTATCGCTAC
TTCTATGGAGT: TCTATGGAGTC
TTCTCTGCGTG: TCTCTGCGTGT
TTCTGTGCGAG: TCTGTGCGAGG
TTCTTATCGTA: TCTTATCGTAG
TTCTTGGAGAA: TCTTGGAGAAA
TTCTTGGCAAC: TCTTGGCAACC
TTCTTGTTCAG: TCTTGTTCAGG
TTCTTTCGGTA: TCTTTCGGTAG
TTGAATAGCAC: TGAATAGCACA
TTGACAAGAAC: TGACAAGAACT
TTGACCGGGAG: TGACCGGGAGT
TTGAGGATATT: TGAGGATATTC
TTGAGGCCCTA: TGAGGCCCTAA
TTGATAAAATA: TGATAAAATAC
TTGATAAAGCT: TGATAAAGCTG
TTGATCTAAGT: TGATCTAAGTT
TTGATTTATTC: TGATTTATTCT
TTGCAACCTAA: TGCAACCTAAT
TTGCAATTTAG: TGCAATTTAGA
TTGCAGTGCGC: TGCAGTGCGCT
TTGCCACTTAA: TGCCACTTAAG
TTGCCAGGAGG: TGCCAGGAGGA
TTGCCCTTTGA: TGCCCTTTGAC
TTGCCTTATTC: TGCCTTATTCT
TTGCTGCCCGA: TGCTGCCCGAC
TTGCTGCGGAA: TGCTGCGGAAG
TTGCTTACTTA: TGCTTACTTAA
TTGGAAGTCCT: TGGAAGTCCTT
TTGGAGAAAGT: TGGAGAAAGTT
TTGGATTAGAA: TGGATTAGAAA
TTGGCAACCTC: TGGCAACCTCC
TTGGCAATGCT: TGGCAATGCTC
TTGGCACGAGT: TGGCACGAGTA
TTGGCCAAACT: TGGCCAAACTA
TTGGCGCAGAC: TGGCGCAGACC
TTGGGACTTCG: TGGGACTTCGT
TTGGGAGATAT: TGGGAGATATG
TTGGGATTCGT: TGGGATTCGTC
TTGGGTAGTGC: TGGGTAGTGCT
TTGGTGATGCA: TGGTGATGCAC
TTGGTGGCAGT: TGGTGGCAGTG
TTGGTTTGCAA: TGGTTTGCAAC
TTGTACATTAG: TGTACATTAGA
TTGTATGGCGT: TGTATGGCGTA
TTGTCAGCTGG: TGTCAGCTGGT
TTGTGCAATTT: TGTGCAATTTT
TTGTGGCTGAG: TGTGGCTGAGC
TTGTTAGCTGC: TGTTAGCTGCC
TTGTTCAGGTC: TGTTCAGGTCT
TTTAAGTAATC: TTAAGTAATCA
TTTAATTTACC: TTAATTTACCG
TTTAATTTAGA: TTAATTTAGAT
TTTACCGGCGA: TTACCGGCGAA
TTTAGAACTAG: TTAGAACTAGG
TTTAGATAACG: TTAGATAACGA
TTTAGCTTAAA: TTAGCTTAAAG
TTTAGTCATGG: TTAGTCATGGG
TTTATCATATG: TTATCATATGG
TTTATTCTTTC: TTATTCTTTCG
TTTCACCGCTG: TTCACCGCTGT
TTTCACTAATG: TTCACTAATGA
TTTCATGCTGA: TTCATGCTGAA
TTTCCTCACGG: TTCCTCACGGA
TTTCGGTAGCA: TTCGGTAGCAA
TTTCGTGAAGT: TTCGTGAAGTC
TTTGACCGGGA: TTGACCGGGAG
TTTGCAACCTA: TTGCAACCTAA
TTTGGAAGTCC: TTGGAAGTCCT
TTTGGATTAGA: TTGGATTAGAA
TTTGGCAATGC: TTGGCAATGCT
TTTGGCCAAAC: TTGGCCAAACT
TTTGGGACTTC: TTGGGACTTCG
TTTGGGATTCG: TTGGGATTCGT
TTTGGTGGCAG: TTGGTGGCAGT
TTTTAATTTAG: TTTAATTTAGA
TTTTCACCGCT: TTTCACCGCTG
TTTTCCTCACG: TTTCCTCACGG
TTTTGGAAGTC: TTTGGAAGTCC
TTTTGGCAATG: TTTGGCAATGC
TTTTGGTGGCA: TTTGGTGGCAG
